aaaadabbd	TRUE
aaaadaabd	FALSE
aabba	TRUE
aadba	FALSE
abbcaaad	TRUE
abcaaad	FALSE
abb	TRUE
ab	FALSE
abbda	TRUE
aabda	FALSE
abb	TRUE
abcb	FALSE
abcbb	TRUE
abcdb	FALSE
abbcd	TRUE
acbcd	FALSE
abba	TRUE
adba	FALSE
abb	TRUE
adb	FALSE
acbbcbddbda	TRUE
acdbcbddbda	FALSE
adbba	TRUE
adba	FALSE
adbb	TRUE
addb	FALSE
bbaada	TRUE
baada	FALSE
bbacbacabdcdaa	TRUE
bacbacabdcdaa	FALSE
bbad	TRUE
bad	FALSE
bbcadabac	TRUE
bcadabac	FALSE
bbcca	TRUE
bcca	FALSE
bbcdd	TRUE
bcdd	FALSE
bbdac	TRUE
bdac	FALSE
bbdca	TRUE
bdca	FALSE
bbdd	TRUE
bdd	FALSE
bb	TRUE
b	FALSE
bb	TRUE
b	FALSE
bb	TRUE
b	FALSE
bbaaabccca	TRUE
abaaabccca	FALSE
bbabdbabdcbddada	TRUE
ababdbabdcbddada	FALSE
bbaddadbcbdadbccda	TRUE
abaddadbcbdadbccda	FALSE
bbcabaabcc	TRUE
abcabaabcc	FALSE
bbcbdb	TRUE
abcbdb	FALSE
bbcdabdaddcc	TRUE
abcdabdaddcc	FALSE
bbc	TRUE
abc	FALSE
bbdbdd	TRUE
abdbdd	FALSE
bbddadcabdcaaccabc	TRUE
abddadcabdcaaccabc	FALSE
bbd	TRUE
abd	FALSE
bb	TRUE
ab	FALSE
bb	TRUE
ab	FALSE
bb	TRUE
ab	FALSE
bbcd	TRUE
babcd	FALSE
bbca	TRUE
bcbca	FALSE
bba	TRUE
bdba	FALSE
baabb	TRUE
baab	FALSE
badbb	TRUE
badb	FALSE
bbd	TRUE
bd	FALSE
bbccbd	TRUE
baccbd	FALSE
bbab	TRUE
bcab	FALSE
bb	TRUE
bc	FALSE
bbd	TRUE
bdd	FALSE
bcbb	TRUE
bccb	FALSE
bdbb	TRUE
bdab	FALSE
bbaab	TRUE
cbaab	FALSE
bbab	TRUE
cbab	FALSE
bbadbd	TRUE
cbadbd	FALSE
bbcaacacba	TRUE
cbcaacacba	FALSE
bbcbddbdc	TRUE
cbcbddbdc	FALSE
bbcdbaa	TRUE
cbcdbaa	FALSE
bbc	TRUE
cbc	FALSE
bbdbccadbcb	TRUE
cbdbccadbcb	FALSE
bbdc	TRUE
cbdc	FALSE
bbd	TRUE
cbd	FALSE
bb	TRUE
cb	FALSE
bb	TRUE
cb	FALSE
bb	TRUE
cb	FALSE
bbaacdbddc	TRUE
dbaacdbddc	FALSE
bbacbcdaabcbcdccb	TRUE
dbacbcdaabcbcdccb	FALSE
bbad	TRUE
dbad	FALSE
bbcac	TRUE
dbcac	FALSE
bbcb	TRUE
dbcb	FALSE
bbcdcdababc	TRUE
dbcdcdababc	FALSE
bbdabac	TRUE
dbdabac	FALSE
bbdbd	TRUE
dbdbd	FALSE
bbdda	TRUE
dbdda	FALSE
bbd	TRUE
dbd	FALSE
bb	TRUE
db	FALSE
bb	TRUE
db	FALSE
bb	TRUE
db	FALSE
cabbababaadb	TRUE
cababababaadb	FALSE
cbbacab	TRUE
cbacab	FALSE
cbb	TRUE
cb	FALSE
cbbc	TRUE
cabc	FALSE
cbbacccacdcbab	TRUE
cbcbacccacdcbab	FALSE
cbbacbddba	TRUE
cbdacbddba	FALSE
cbbccbcb	TRUE
ccbccbcb	FALSE
cbb	TRUE
ccb	FALSE
cbbdddad	TRUE
cdbdddad	FALSE
ccbbdd	TRUE
ccabdd	FALSE
ccdbbca	TRUE
ccdcbca	FALSE
cdbbd	TRUE
cdcbd	FALSE
dabb	TRUE
dab	FALSE
dadcbbc	TRUE
dadcbabc	FALSE
dbbdc	TRUE
dbdc	FALSE
dbbcacaddac	TRUE
dabcacaddac	FALSE
dbb	TRUE
dab	FALSE
dbbaacadbd	TRUE
dbcaacadbd	FALSE
dbbad	TRUE
dcbad	FALSE
dbb	TRUE
dcb	FALSE
dbbdbdadddaa	TRUE
ddbdbdadddaa	FALSE
dcbbcdb	TRUE
dcbcdb	FALSE
dcbb	TRUE
dcdb	FALSE
ddbbc	TRUE
ddabc	FALSE
aaaabb	TRUE
aaaadb	FALSE
aabbac	TRUE
aadbac	FALSE
abbadc	TRUE
abadc	FALSE
abbdca	TRUE
abdca	FALSE
abbcc	TRUE
aabcc	FALSE
abbadb	TRUE
abdbadb	FALSE
abdbbc	TRUE
abdbc	FALSE
abbcb	TRUE
acbcb	FALSE
abbacb	TRUE
adbacb	FALSE
abbdcd	TRUE
adbdcd	FALSE
acbba	TRUE
accba	FALSE
adbbcc	TRUE
adbcc	FALSE
adbbdc	TRUE
addbdc	FALSE
bbaabc	TRUE
baabc	FALSE
bbabca	TRUE
babca	FALSE
bbacbd	TRUE
bacbd	FALSE
bbadad	TRUE
badad	FALSE
bbcaaa	TRUE
bcaaa	FALSE
bbcbaa	TRUE
bcbaa	FALSE
bbcca	TRUE
bcca	FALSE
bbcdad	TRUE
bcdad	FALSE
bbdaac	TRUE
bdaac	FALSE
bbdbab	TRUE
bdbab	FALSE
bbdbd	TRUE
bdbd	FALSE
bbdcdd	TRUE
bdcdd	FALSE
bbaaaa	TRUE
abaaaa	FALSE
bbabab	TRUE
ababab	FALSE
bbacaa	TRUE
abacaa	FALSE
bbacd	TRUE
abacd	FALSE
bbaddd	TRUE
abaddd	FALSE
bbcadd	TRUE
abcadd	FALSE
bbcbdd	TRUE
abcbdd	FALSE
bbccdc	TRUE
abccdc	FALSE
bbcdcc	TRUE
abcdcc	FALSE
bbdacd	TRUE
abdacd	FALSE
bbdbcc	TRUE
abdbcc	FALSE
bbdccb	TRUE
abdccb	FALSE
bbddcb	TRUE
abddcb	FALSE
bbcbdb	TRUE
babcbdb	FALSE
bbadca	TRUE
bcbadca	FALSE
bbaadc	TRUE
bdbaadc	FALSE
bbddaa	TRUE
bdbddaa	FALSE
badabb	TRUE
badab	FALSE
bbdaad	TRUE
bdaad	FALSE
bbbdb	TRUE
babdb	FALSE
bbbacc	TRUE
bcbacc	FALSE
bbadcc	TRUE
bdadcc	FALSE
bcabba	TRUE
bcaaba	FALSE
bccabb	TRUE
bccaab	FALSE
bdbcbb	TRUE
bdbcdb	FALSE
bbaaba	TRUE
cbaaba	FALSE
bbabac	TRUE
cbabac	FALSE
bbacaa	TRUE
cbacaa	FALSE
bbacdc	TRUE
cbacdc	FALSE
bbaddc	TRUE
cbaddc	FALSE
bbcadb	TRUE
cbcadb	FALSE
bbcbc	TRUE
cbcbc	FALSE
bbccbc	TRUE
cbccbc	FALSE
bbcdbc	TRUE
cbcdbc	FALSE
bbdaba	TRUE
cbdaba	FALSE
bbdba	TRUE
cbdba	FALSE
bbdcbc	TRUE
cbdcbc	FALSE
bbddbc	TRUE
cbddbc	FALSE
bbaaba	TRUE
dbaaba	FALSE
bbaba	TRUE
dbaba	FALSE
bbacba	TRUE
dbacba	FALSE
bbadac	TRUE
dbadac	FALSE
bbcaad	TRUE
dbcaad	FALSE
bbcbad	TRUE
dbcbad	FALSE
bbcca	TRUE
dbcca	FALSE
bbcdac	TRUE
dbcdac	FALSE
bbcdd	TRUE
dbcdd	FALSE
bbdadb	TRUE
dbdadb	FALSE
bbdbda	TRUE
dbdbda	FALSE
bbdcda	TRUE
dbdcda	FALSE
bbddcd	TRUE
dbddcd	FALSE
cabdbb	TRUE
cabdb	FALSE
cbbaca	TRUE
cbaca	FALSE
cbbdbc	TRUE
cbdbc	FALSE
cbbcaa	TRUE
cabcaa	FALSE
cbbcbd	TRUE
cbabcbd	FALSE
cbbba	TRUE
cbcba	FALSE
cbbadc	TRUE
ccbadc	FALSE
cbbdda	TRUE
ccbdda	FALSE
cbbcdd	TRUE
cdbcdd	FALSE
ccbbab	TRUE
ccabab	FALSE
cccdbb	TRUE
cccdab	FALSE
cdbba	TRUE
cdcba	FALSE
dabbca	TRUE
daabca	FALSE
dbbaba	TRUE
dbaba	FALSE
dbbdab	TRUE
dbdab	FALSE
dbbadc	TRUE
dabadc	FALSE
dbbddb	TRUE
dabddb	FALSE
dbbcba	TRUE
dbacba	FALSE
dbbadc	TRUE
dcbadc	FALSE
dbbdd	TRUE
dcbdd	FALSE
dbbcdc	TRUE
ddbcdc	FALSE
dcbba	TRUE
dcba	FALSE
dccabb	TRUE
dccacb	FALSE
ddbabb	TRUE
ddbab	FALSE
aaaadbbcda	TRUE
aaaadabcda	FALSE
aabbcddbac	TRUE
aacbcddbac	FALSE
abbabacccbc	TRUE
ababacccbc	FALSE
abbdacddcab	TRUE
abdacddcab	FALSE
abbcbcccdc	TRUE
aabcbcccdc	FALSE
abbacaddcdc	TRUE
abcbacaddcdc	FALSE
abbbdaabcca	TRUE
abdbdaabcca	FALSE
abbcbcaaad	TRUE
acbcbcaaad	FALSE
abbaacadabd	TRUE
adbaacadabd	FALSE
abbdaacdadd	TRUE
adbdaacdadd	FALSE
acbabbadcda	TRUE
acbabadcda	FALSE
adbbacdbdab	TRUE
adbacdbdab	FALSE
adcbbcbddbd	TRUE
adcdbcbddbd	FALSE
bbaaccbcacc	TRUE
baaccbcacc	FALSE
bbabcdccbdd	TRUE
babcdccbdd	FALSE
bbacdbacdab	TRUE
bacdbacdab	FALSE
bbaddbdbcaa	TRUE
baddbdbcaa	FALSE
bbcadacbdab	TRUE
bcadacbdab	FALSE
bbcbdabdaca	TRUE
bcbdabdaca	FALSE
bbcccbdcadc	TRUE
bcccbdcadc	FALSE
bbcdcabdcb	TRUE
bcdcabdcb	FALSE
bbdacbaddab	TRUE
bdacbaddab	FALSE
bbdbcdccacb	TRUE
bdbcdccacb	FALSE
bbdccbcdbcd	TRUE
bdccbcdbcd	FALSE
bbddcbccbca	TRUE
bddcbccbca	FALSE
bbaacbcbcad	TRUE
abaacbcbcad	FALSE
bbabcbcdaad	TRUE
ababcbcdaad	FALSE
bbacbccdaba	TRUE
abacbccdaba	FALSE
bbadccbaddc	TRUE
abadccbaddc	FALSE
bbcaccbabc	TRUE
abcaccbabc	FALSE
bbcbcbdbdbc	TRUE
abcbcbdbdbc	FALSE
bbccbcdabcb	TRUE
abccbcdabcb	FALSE
bbcdbaaccbc	TRUE
abcdbaaccbc	FALSE
bbdaabdbcba	TRUE
abdaabdbcba	FALSE
bbdadcddcca	TRUE
abdadcddcca	FALSE
bbdbddaabdc	TRUE
abdbddaabdc	FALSE
bbddaaadddb	TRUE
abddaaadddb	FALSE
bbddddcdcbc	TRUE
abddddcdcbc	FALSE
bbdcbdccacd	TRUE
babdcbdccacd	FALSE
bbcddadcdb	TRUE
bcbcddadcdb	FALSE
bbcaaddbadd	TRUE
bdbcaaddbadd	FALSE
baabbcabcb	TRUE
baadbcabcb	FALSE
badabbacddd	TRUE
badabaacddd	FALSE
bbcdcbdbabc	TRUE
bcdcbdbabc	FALSE
bbbdbabddaa	TRUE
babdbabddaa	FALSE
bbaddbaddba	TRUE
bcaddbaddba	FALSE
bbacaaadbda	TRUE
bdacaaadbda	FALSE
bcabbddcddb	TRUE
bcaabddcddb	FALSE
bccbbaadcb	TRUE
bccbaadcb	FALSE
bdbccdbbcaa	TRUE
bdbccdcbcaa	FALSE
bbaabccacdd	TRUE
cbaabccacdd	FALSE
bbabcababac	TRUE
cbabcababac	FALSE
bbacbcadabc	TRUE
cbacbcadabc	FALSE
bbadbadcdaa	TRUE
cbadbadcdaa	FALSE
bbcabadbcaa	TRUE
cbcabadbcaa	FALSE
bbcbaddacc	TRUE
cbcbaddacc	FALSE
bbccadbcaca	TRUE
cbccadbcaca	FALSE
bbcdaddaada	TRUE
cbcdaddaada	FALSE
bbdabaaabda	TRUE
cbdabaaabda	FALSE
bbdbabaadad	TRUE
cbdbabaadad	FALSE
bbdcbaaaaac	TRUE
cbdcbaaaaac	FALSE
bbddaabcdab	TRUE
cbddaabcdab	FALSE
bbaaaadadcb	TRUE
dbaaaadadcb	FALSE
bbaadcbddca	TRUE
dbaadcbddca	FALSE
bbabdccabca	TRUE
dbabdccabca	FALSE
bbacdcacba	TRUE
dbacdcacba	FALSE
bbaddcaaada	TRUE
dbaddcaaada	FALSE
bbcbaabaabc	TRUE
dbcbaabaabc	FALSE
bbcbdbccca	TRUE
dbcbdbccca	FALSE
bbccdbaaacc	TRUE
dbccdbaaacc	FALSE
bbcddadbddb	TRUE
dbcddadbddb	FALSE
bbdacddacdb	TRUE
dbdacddacdb	FALSE
bbdbdcaacda	TRUE
dbdbdcaacda	FALSE
bbdcdaadab	TRUE
dbdcdaadab	FALSE
bbdddadccdb	TRUE
dbdddadccdb	FALSE
cabbaadaab	TRUE
cabaaadaab	FALSE
cbbaadadadc	TRUE
cbaadadadc	FALSE
cbbdbaddcbc	TRUE
cbdbaddcbc	FALSE
cbbcbcbcbcc	TRUE
cabcbcbcbcc	FALSE
cbbacccccbc	TRUE
cbcbacccccbc	FALSE
cbbcbdbcdac	TRUE
cbdcbdbcdac	FALSE
cbbaddbdbda	TRUE
ccbaddbdbda	FALSE
cbbddbcaabd	TRUE
ccbddbcaabd	FALSE
cbbcccdbdac	TRUE
cdbcccdbdac	FALSE
ccacbbabaca	TRUE
ccacababaca	FALSE
cccbbdacacb	TRUE
cccabdacacb	FALSE
cdbbabdbcdd	TRUE
cdcbabdbcdd	FALSE
daadbbddbaa	TRUE
daadcbddbaa	FALSE
dacbbccacbc	TRUE
dacbaccacbc	FALSE
dbbcbcaabcb	TRUE
dbcbcaabcb	FALSE
dbbdddbaadc	TRUE
dbdddbaadc	FALSE
dbbdaadbddc	TRUE
dabdaadbddc	FALSE
dbbcdccdacd	TRUE
dbdbcdccdacd	FALSE
dbbaaacabda	TRUE
dcbaaacabda	FALSE
dbbccdabcba	TRUE
dcbccdabcba	FALSE
dbbabcabcaa	TRUE
ddbabcabcaa	FALSE
dbbdaaabdcd	TRUE
ddbdaaabdcd	FALSE
dcbbddcccab	TRUE
dcbddcccab	FALSE
dccbbddbaad	TRUE
dccbddbaad	FALSE
ddbbddadbdb	TRUE
ddabddadbdb	FALSE
aaaabbdcbaddbaad	TRUE
aaaabdcbaddbaad	FALSE
aabbabcacadbcaba	TRUE
aadbabcacadbcaba	FALSE
abbadddbadddbdca	TRUE
abadddbadddbdca	FALSE
abbaacacaaabdcad	TRUE
aabaacacaaabdcad	FALSE
abbcddaccaabdbdc	TRUE
aabcddaccaabdbdc	FALSE
abbabdadadccbdba	TRUE
abdbabdadadccbdba	FALSE
abbcaadadaaabcb	TRUE
abdcaadadaaabcb	FALSE
abbaddbdabacdcdd	TRUE
acbaddbdabacdcdd	FALSE
abbddacaacdcaab	TRUE
acbddacaacdcaab	FALSE
abbcbddbccadbcda	TRUE
adbcbddbccadbcda	FALSE
acbbaccdbcacaadd	TRUE
acbaccdbcacaadd	FALSE
accbbdabaadacabd	TRUE
accabdabaadacabd	FALSE
adbbabacbdaaccda	TRUE
adbcbabacbdaaccda	FALSE
bbaaaabcdcdadaca	TRUE
baaaabcdcdadaca	FALSE
bbabaacbcdaaddaa	TRUE
babaacbcdaaddaa	FALSE
bbacaccdccbabcbd	TRUE
bacaccdccbabcbd	FALSE
bbadaddadccbacad	TRUE
badaddadccbacad	FALSE
bbcaadbddabccbdb	TRUE
bcaadbddabccbdb	FALSE
bbcbacaccbcbddad	TRUE
bcbacaccbcbddad	FALSE
bbcbddcccdbddddc	TRUE
bcbddcccdbddddc	FALSE
bbccdacdcddcccda	TRUE
bccdacdcddcccda	FALSE
bbcdcdcbaddbcdc	TRUE
bcdcdcbaddbcdc	FALSE
bbdaccadbadabdcb	TRUE
bdaccadbadabdcb	FALSE
bbdbccbdbacddadb	TRUE
bdbccbdbacddadb	FALSE
bbdccbabcdcbcdbd	TRUE
bdccbabcdcbcdbd	FALSE
bbdddcaccdcdacda	TRUE
bdddcaccdcdacda	FALSE
bbaadbcbabddaddd	TRUE
abaadbcbabddaddd	FALSE
bbabdccbdcdbcbac	TRUE
ababdccbdcdbcbac	FALSE
bbacdbdbaccadbaa	TRUE
abacdbdbaccadbaa	FALSE
bbadddcbcadcabab	TRUE
abadddcbcadcabab	FALSE
bbcbaabcdbdadbdb	TRUE
abcbaabcdbdadbdb	FALSE
bbccaaccacdaaca	TRUE
abccaaccacdaaca	FALSE
bbccdcbdaaacadd	TRUE
abccdcbdaaacadd	FALSE
bbcddbdddbccaada	TRUE
abcddbdddbccaada	FALSE
bbdacdcccdbdbdbc	TRUE
abdacdcccdbdbdbc	FALSE
bbdbdbadadaabdcd	TRUE
abdbdbadadaabdcd	FALSE
bbdcdbcdadbaddac	TRUE
abdcdbcdadbaddac	FALSE
bbdddcdbcbcaabac	TRUE
abdddcdbcbcaabac	FALSE
bbdabcdbccaabdac	TRUE
babdabcdbccaabdac	FALSE
bbcbcbcaaacbabab	TRUE
bcbcbcbcaaacbabab	FALSE
bbadddaddcdabccc	TRUE
bdbadddaddcdabccc	FALSE
babbcabddabcdcad	TRUE
babcabddabcdcad	FALSE
badadadbbdadaaba	TRUE
badadadabdadaaba	FALSE
bbcddabcbcbaccad	TRUE
bcddabcbcbaccad	FALSE
bbcbcbccacccccba	TRUE
bacbcbccacccccba	FALSE
bbbcaaabcbcbadd	TRUE
bcbcaaabcbcbadd	FALSE
bbadcdbdbaaadbda	TRUE
bdadcdbdbaaadbda	FALSE
bcaaacaaabbddccb	TRUE
bcaaacaaacbddccb	FALSE
bccbbdbdbaabaada	TRUE
bccbdbdbaabaada	FALSE
bdbbddddadddadcd	TRUE
bdcbddddadddadcd	FALSE
bbaaccbdacacccc	TRUE
cbaaccbdacacccc	FALSE
bbabdadaaddccccd	TRUE
cbabdadaaddccccd	FALSE
bbaccadbcddccdad	TRUE
cbaccadbcddccdad	FALSE
bbadbddbddbadbdd	TRUE
cbadbddbddbadbdd	FALSE
bbcabacdbdbcdcb	TRUE
cbcabacdbdbcdcb	FALSE
bbcbadadadbdadba	TRUE
cbcbadadadbdadba	FALSE
bbccadabddbdbaaa	TRUE
cbccadabddbdbaaa	FALSE
bbcdaacabdcabcb	TRUE
cbcdaacabdcabcb	FALSE
bbcddbadccabacba	TRUE
cbcddbadccabacba	FALSE
bbdadbccaabdacb	TRUE
cbdadbccaabdacb	FALSE
bbdbdbcacccbdabd	TRUE
cbdbdbcacccbdabd	FALSE
bbdccdcbcaadabcd	TRUE
cbdccdcbcaadabcd	FALSE
bbddcdacdabaccbc	TRUE
cbddcdacdabaccbc	FALSE
bbaadabddacdaabc	TRUE
dbaadabddacdaabc	FALSE
bbabcdbddabcaba	TRUE
dbabcdbddabcaba	FALSE
bbaccbacacbcabad	TRUE
dbaccbacacbcabad	FALSE
bbadbdbdbcbdcba	TRUE
dbadbdbdbcbdcba	FALSE
bbcabaddbaddddda	TRUE
dbcabaddbaddddda	FALSE
bbcbadddbcacdaaa	TRUE
dbcbadddbcacdaaa	FALSE
bbccabcacdbcbdca	TRUE
dbccabcacdbcbdca	FALSE
bbcdaaaadaaddcdb	TRUE
dbcdaaaadaaddcdb	FALSE
bbcddcdaaaabdcbc	TRUE
dbcddcdaaaabdcbc	FALSE
bbdadcdbddddadbc	TRUE
dbdadcdbddddadbc	FALSE
bbdbdccabddbacc	TRUE
dbdbdccabddbacc	FALSE
bbdcdcbdbdadddba	TRUE
dbdcdcbdbdadddba	FALSE
bbdddcbacaccddcc	TRUE
dbdddcbacaccddcc	FALSE
cabbdadcacdaacaa	TRUE
cacbdadcacdaacaa	FALSE
cbbabadaccacaaaa	TRUE
cbabadaccacaaaa	FALSE
cbbdbacbdbabacc	TRUE
cbdbacbdbabacc	FALSE
cbbccddcddabdadb	TRUE
cabccddcddabdadb	FALSE
cbbdcddcadddbcdc	TRUE
cbcbdcddcadddbcdc	FALSE
cbcbbacaabdbadcc	TRUE
cbcbacaabdbadcc	FALSE
cbbcacdcabdacdcb	TRUE
ccbcacdcabdacdcb	FALSE
cbbaabdbdaddcaba	TRUE
cdbaabdbdaddcaba	FALSE
cbbdacacbddcdbca	TRUE
cdbdacacbddcdbca	FALSE
ccbbdccacaaaaca	TRUE
ccbabdccacaaaaca	FALSE
ccdbbacbabdbcdcb	TRUE
ccddbacbabdbcdcb	FALSE
cdbbccdaabdbdadd	TRUE
cdcbccdaabdbdadd	FALSE
dabbacdbacbcdab	TRUE
dabacdbacbcdab	FALSE
dacbbccdddacccb	TRUE
dacabccdddacccb	FALSE
dbbcaadcabdcccc	TRUE
dbcaadcabdcccc	FALSE
dbbaabcdbcdbdddd	TRUE
dabaabcdbcdbdddd	FALSE
dbbdacadcaabdcac	TRUE
dabdacadcaabdcac	FALSE
dbacaacbbccaaadd	TRUE
dbacaacbcccaaadd	FALSE
dbbaaaadadadbccb	TRUE
dcbaaaadadadbccb	FALSE
dbbccccaaaaaddaa	TRUE
dcbccccaaaaaddaa	FALSE
dbbacabddccadbcd	TRUE
ddbacabddccadbcd	FALSE
dbbdcaaacacbdcbc	TRUE
ddbdcaaacacbdcbc	FALSE
dcbbdaacdcacddb	TRUE
dccbdaacdcacddb	FALSE
ddbbdaaaccacddba	TRUE
ddbcbdaaaccacddba	FALSE
aaabbaabdacacbdcdbcac	TRUE
aaabaabdacacbdcdbcac	FALSE
aabbcccaddbdbcbababdd	TRUE
aadbcccaddbdbcbababdd	FALSE
abbcabdddcabacddcbacd	TRUE
abcabdddcabacddcbacd	FALSE
abbddcbdbdacaccbaddac	TRUE
abddcbdbdacaccbaddac	FALSE
abbcdababababddabdbdc	TRUE
aabcdababababddabdbdc	FALSE
abbdcbaacbcbaccabdcaa	TRUE
abcbdcbaacbcbaccabdcaa	FALSE
abcbbdacbcadddaaddcbc	TRUE
abcbdacbcadddaaddcbc	FALSE
abbcabcaaacccdaabadad	TRUE
acbcabcaaacccdaabadad	FALSE
abbddbadbdcdcdcaabcb	TRUE
acbddbadbdcdcdcaabcb	FALSE
abbcdaacdccddbcbaddb	TRUE
adbcdaacdccddbcbaddb	FALSE
acbbcddabdaadccdcacdd	TRUE
acbcddabdaadccdcacdd	FALSE
acbbdddbdbcdabadcdac	TRUE
acdbdddbdbcdabadcdac	FALSE
adbbdddbacaaddbaadaca	TRUE
adabdddbacaaddbaadaca	FALSE
addbbaabcbddcaaadcdc	TRUE
adddbaabcbddcaaadcdc	FALSE
bbaacdcddbcccbdacbdd	TRUE
baacdcddbcccbdacbdd	FALSE
bbabdabaabacdddcbadb	TRUE
babdabaabacdddcbadb	FALSE
bbacccccacbddcdccddda	TRUE
bacccccacbddcdccddda	FALSE
bbaddaccacdbadddcbda	TRUE
baddaccacdbadddcbda	FALSE
bbcadadbdcccbdadadada	TRUE
bcadadbdcccbdadadada	FALSE
bbccaacdcadacdababaca	TRUE
bccaacdcadacdababaca	FALSE
bbcdaababaacbcaaadccb	TRUE
bcdaababaacbcaaadccb	FALSE
bbcddcbaaadaccabccada	TRUE
bcddcbaaadaccabccada	FALSE
bbdadbacccabddcaccdba	TRUE
bdadbacccabddcaccdba	FALSE
bbdbdcbdabcccbacbdcb	TRUE
bdbdcbdabcccbacbdcb	FALSE
bbdcdaddbaddbaabacdcc	TRUE
bdcdaddbaddbaabacdcc	FALSE
bbddcdddaccadcdcbabdc	TRUE
bddcdddaccadcdcbabdc	FALSE
bbaacdcdccccaadbaccac	TRUE
abaacdcdccccaadbaccac	FALSE
bbabcddcadcabcbdbdbca	TRUE
ababcddcadcabcbdbdbca	FALSE
bbacbdddbcbdcbacabcba	TRUE
abacbdddbcbdcbacabcba	FALSE
bbadcadddaaadbadcbabd	TRUE
abadcadddaaadbadcbabd	FALSE
bbcacadbaadddbddcacda	TRUE
abcacadbaadddbddcacda	FALSE
bbcbdabccaaaacbddcbdb	TRUE
abcbdabccaaaacbddcbdb	FALSE
bbcccbadabdbccccbdadc	TRUE
abcccbadabdbccccbdadc	FALSE
bbcdbdacdccdccadcadcc	TRUE
abcdbdacdccdccadcadcc	FALSE
bbdabcaaabadcbccccdba	TRUE
abdabcaaabadcbccccdba	FALSE
bbdbadbcacccdcbdacdda	TRUE
abdbadbcacccdcbdacdda	FALSE
bbdcbaacdcdcbcabccddc	TRUE
abdcbaacdcdcbcabccddc	FALSE
bbddbababcddcadcbabca	TRUE
abddbababcddcadcbabca	FALSE
bbacbdaccddcdddcbdbc	TRUE
babacbdaccddcdddcbdbc	FALSE
bbddcdaacbcdbdaadccac	TRUE
babddcdaacbcdbdaadccac	FALSE
bbdcbcaaccbcddacbddca	TRUE
bcbdcbcaaccbcddacbddca	FALSE
bbdabdadcdccdcaabcaba	TRUE
bdbdabdadcdccdcaabcaba	FALSE
babbccbabcdbcbabddac	TRUE
bacbccbabcdbcbabddac	FALSE
bbadcbadbdaccaccadac	TRUE
badcbadbdaccaccadac	FALSE
bbacbabcbddcdcdacddbd	TRUE
baacbabcbddcdcdacddbd	FALSE
bbddadadbddacccbaaabc	TRUE
baddadadbddacccbaaabc	FALSE
bbcbdcabcbcbdcbdabaad	TRUE
bccbdcabcbcbdcbdabaad	FALSE
bbbabdbdadbabaabcabaa	TRUE
bdbabdbdadbabaabcabaa	FALSE
bcacbbaadccddaddbacca	TRUE
bcaccbaadccddaddbacca	FALSE
bcdbbadbddcbaccaacbcc	TRUE
bcddbadbddcbaccaacbcc	FALSE
bdcbbdbaabcccdbcbdadb	TRUE
bdccbdbaabcccdbcbdadb	FALSE
bbaadaadadcaccdabddb	TRUE
cbaadaadadcaccdabddb	FALSE
bbabdacbcaddbcdaaddc	TRUE
cbabdacbcaddbcdaaddc	FALSE
bbacdbadddadbcccbcba	TRUE
cbacdbadddadbcccbcba	FALSE
bbadcdccdbcbdbddbdacc	TRUE
cbadcdccdbcbdbddbdacc	FALSE
bbcacbccaadcaddacdcdd	TRUE
cbcacbccaadcaddacdcdd	FALSE
bbcbdabcaddaabcddadd	TRUE
cbcbdabcaddaabcddadd	FALSE
bbcccdadddddbaddbdaac	TRUE
cbcccdadddddbaddbdaac	FALSE
bbcdcbaaabcabaabcddad	TRUE
cbcdcbaaabcabaabcddad	FALSE
bbdacbccacddbacdccbad	TRUE
cbdacbccacddbacdccbad	FALSE
bbdbcdadaaabccdbaadda	TRUE
cbdbcdadaaabccdbaadda	FALSE
bbdccbdcacbabccadaab	TRUE
cbdccbdcacbabccadaab	FALSE
bbdddbdaacbabacabadcb	TRUE
cbdddbdaacbabacabadcb	FALSE
bbaacdcbcdaacccaaccd	TRUE
dbaacdcbcdaacccaaccd	FALSE
bbabccacbcbdaabacbcac	TRUE
dbabccacbcbdaabacbcac	FALSE
bbacbccdaacdbdddacbca	TRUE
dbacbccdaacdbdddacbca	FALSE
bbadbadbcbdabcdcddbc	TRUE
dbadbadbcbdabcdcddbc	FALSE
bbcabdadbacddaababccc	TRUE
dbcabdadbacddaababccc	FALSE
bbcbcbabdcdcbddcbddbc	TRUE
dbcbcbabdcdcbddcbddbc	FALSE
bbccbcdbadabdcdbdabda	TRUE
dbccbcdbadabdcdbdabda	FALSE
bbcdbaddadaabddabdadb	TRUE
dbcdbaddadaabddabdadb	FALSE
bbdaaddccdbaabdddabab	TRUE
dbdaaddccdbaabdddabab	FALSE
bbdbacdaaaadcabdbaab	TRUE
dbdbacdaaaadcabdbaab	FALSE
bbdcaabdcbabcacccbddb	TRUE
dbdcaabdcbabcacccbddb	FALSE
bbddaacadacdbabdcddcc	TRUE
dbddaacadacdbabdcddcc	FALSE
bbddddcbcdbcbadadbcca	TRUE
dbddddcbcdbcbadadbcca	FALSE
cabbdddcdacaacbddabcb	TRUE
cacbdddcdacaacbddabcb	FALSE
cbbacaddcdcabddccdad	TRUE
cbacaddcdcabddccdad	FALSE
cbbdbdcdbdddbccacabdb	TRUE
cbdbdcdbdddbccacabdb	FALSE
cbbcbdbcaaccdacdbdddd	TRUE
cabcbdbcaaccdacdbdddd	FALSE
cbbcbabdcbcbcdaccdabc	TRUE
cbcbcbabdcbcbcdaccdabc	FALSE
cbdbbdabcaaaaaacbaabc	TRUE
cbdabdabcaaaaaacbaabc	FALSE
cbbccadabcdccabcaaabc	TRUE
ccbccadabcdccabcaaabc	FALSE
cbbacddabcbccaccadbcb	TRUE
cdbacddabcbccaccadbcb	FALSE
cbbdccabdaddbacacdbac	TRUE
cdbdccabdaddbacacdbac	FALSE
ccbbdaadacccbcbccccdc	TRUE
cccbdaadacccbcbccccdc	FALSE
cdbbaddaacbcccadaadcd	TRUE
cdbaddaacbcccadaadcd	FALSE
cdbbcdddcbcccbadaabcb	TRUE
cddbcdddcbcccbadaabcb	FALSE
dabbaaddcccbdaaabaab	TRUE
daabaaddcccbdaaabaab	FALSE
dacbbccaabcdacccbadd	TRUE
dacbdccaabcdacccbadd	FALSE
dbbcbabcbcddbaacdcda	TRUE
dbcbabcbcddbaacdcda	FALSE
dbbaabcddddaccacadaaa	TRUE
dabaabcddddaccacadaaa	FALSE
dbbdadbcbaacddadbdcdb	TRUE
dabdadbcbaacddadbdcdb	FALSE
dbabbddcbddcdaacbadba	TRUE
dbacbddcbddcdaacbadba	FALSE
dbddbbadcdaaabcaddbaa	TRUE
dbddbadcdaaabcaddbaa	FALSE
dbbdabdbabcabcbdcbcda	TRUE
dcbdabdbabcabcbdcbcda	FALSE
dbbcabaabcddbacdccccc	TRUE
ddbcabaabcddbacdccccc	FALSE
dcabbdddbcbcaadbdaba	TRUE
dcabdddbcbcaadbdaba	FALSE
dcbbabadabcacdcbaaad	TRUE
dcdbabadabcacdcbaaad	FALSE
ddbbcdbdbdaabcdabcdb	TRUE
ddabcdbdbdaabcdabcdb	FALSE
aaaabbabacadaaccbdccadbca	TRUE
aaaadbabacadaaccbdccadbca	FALSE
aabbcbdbabcccddccbdcabaaac	TRUE
aadbcbdbabcccddccbdcabaaac	FALSE
abbadccabccbaabcccccacbca	TRUE
abadccabccbaabcccccacbca	FALSE
abbaaaadddcdbcbababaaacddc	TRUE
aabaaaadddcdbcbababaaacddc	FALSE
abbcdbccdcdacdddcddbddcddc	TRUE
aabcdbccdcdacdddcddbddcddc	FALSE
abbdbacbcdcccdcabaabcaddca	TRUE
abcbdbacbcdcccdcabaabcaddca	FALSE
abbdcccaadabddaccdacddbadd	TRUE
abddcccaadabddaccdacddbadd	FALSE
abbccadcccccbcadabdacdaada	TRUE
acbccadcccccbcadabdacdaada	FALSE
abbabdbadacaacdabcbdcddbc	TRUE
adbabdbadacaacdabcbdcddbc	FALSE
abbdbcbcaaccabdddbaaacdbdb	TRUE
adbdbcbcaaccabdddbaaacdbdb	FALSE
acbbcaaababccbddcbccdccccb	TRUE
accbcaaababccbddcbccdccccb	FALSE
adbbcccbccdcdcdcdbcacdddca	TRUE
adbcccbccdcdcdcdbcacdddca	FALSE
addbbcccdcdcaccbcddbdadcb	TRUE
addabcccdcdcaccbcddbdadcb	FALSE
bbaaccaaacacbdbacabadcabcc	TRUE
baaccaaacacbdbacabadcabcc	FALSE
bbabcbdcbddcccdaacaccbacbc	TRUE
babcbdcbddcccdaacaccbacbc	FALSE
bbacbddcbddbdbacbcdbccdbdb	TRUE
bacbddcbddbdbacbcdbccdbdb	FALSE
bbadbdcddaabcbcdbdbdcdbdca	TRUE
badbdcddaabcbcdbdbdcdbdca	FALSE
bbcabdaddcadcabdabdccacccb	TRUE
bcabdaddcadcabdabdccacccb	FALSE
bbcbccacabcdbcadcdbabddaad	TRUE
bcbccacabcdbcadcdbabddaad	FALSE
bbcccacdabcdaababccbdcdcba	TRUE
bcccacdabcdaababccbdcdcba	FALSE
bbcdbccbacadbcdbdcdddcdcda	TRUE
bcdbccbacadbcdbdcdddcdcda	FALSE
bbdababddcddaccbdcccbdabdb	TRUE
bdababddcddaccbdcccbdabdb	FALSE
bbdbadaaaddaccbccccddabddb	TRUE
bdbadaaaddaccbccccddabddb	FALSE
bbdcbacadcbccdcaacacacbadb	TRUE
bdcbacadcbccdcaacacacbadb	FALSE
bbddbdcadadbdcbddadabdaaba	TRUE
bddbdcadadbdcbddadabdaaba	FALSE
bbaacacdcdcacabdaaddcdcdab	TRUE
abaacacdcdcacabdaaddcdcdab	FALSE
bbabcbadabaaacbddcbdbacddb	TRUE
ababcbadabaaacbddcbdbacddb	FALSE
bbacbcdadadbddcbadbddcccdd	TRUE
abacbcdadadbddcbadbddcccdd	FALSE
bbadbcbabaaacadddadbaabccb	TRUE
abadbcbabaaacadddadbaabccb	FALSE
bbcabacaabcbcdcdabcdcacbcc	TRUE
abcabacaabcbcdcdabcdcacbcc	FALSE
bbcbaccbaababacadaacbdbddd	TRUE
abcbaccbaababacadaacbdbddd	FALSE
bbccbacbcbcabaabaaabcbddcd	TRUE
abccbacbcbcabaabaaabcbddcd	FALSE
bbcdacbacaacdacacbdbcdaddb	TRUE
abcdacbacaacdacacbdbcdaddb	FALSE
bbdaacbdccbdbaacbaddabdacc	TRUE
abdaacbdccbdbaacbaddabdacc	FALSE
bbdbabcbdcadabdabacadcbadc	TRUE
abdbabcbdcadabdabacadcbadc	FALSE
bbdcbaacaacdacbcccdaccacb	TRUE
abdcbaacaacdacbcccdaccacb	FALSE
bbddbaacacacbddabccabdabcb	TRUE
abddbaacacacbddabccabdabcb	FALSE
bbacbddbdbcadcbacaabccacda	TRUE
babacbddbdbcadcbacaabccacda	FALSE
bbdccacdababcbaaccbcababcc	TRUE
babdccacdababcbaaccbcababcc	FALSE
bbcdaccbcacdbdccbcabcadbac	TRUE
bcbcdaccbcacdbdccbcabcadbac	FALSE
bbcbcacaacdbddbcdccbdddcad	TRUE
bdbcbcacaacdbddbcdccbdddcad	FALSE
babbcbdaddaadaadbaabacbacc	TRUE
babcbdaddaadaadbaabacbacc	FALSE
bbaccddacdcdbddabcddddcbcb	TRUE
baccddacdcdbddabcddddcbcb	FALSE
bbabcabccdccabdbccabcacccc	TRUE
baabcabccdccabdbccabcacccc	FALSE
bbdcdcccaaacdcbcdcbcddbcbc	TRUE
badcdcccaaacdcbcdcbcddbcbc	FALSE
bbdbcacdacbdbcdbdaddbdcddc	TRUE
bcdbcacdacbdbcdbdaddbdcddc	FALSE
bbcbcdaccbabdcccdbcdddddaa	TRUE
bdcbcdaccbabdcccdbcdddddaa	FALSE
bcbbacdabcbdbdcccddbacbcac	TRUE
bcabacdabcbdbdcccddbacbcac	FALSE
bdaabbcdbcabacccacbacaaadc	TRUE
bdaabcdbcabacccacbacaaadc	FALSE
bdccbbcbcbaabddadabdbcdabd	TRUE
bdccbdbcbcbaabddadabdbcdabd	FALSE
bbaacdaacacdbcbcaacdcdadab	TRUE
cbaacdaacacdbcbcaacdcdadab	FALSE
bbabdaccccccdcbccccbaacacd	TRUE
cbabdaccccccdcbccccbaacacd	FALSE
bbaccdbacaccccadddccbacadd	TRUE
cbaccdbacaccccadddccbacadd	FALSE
bbaddcacbcdccacbcdbcbdaddc	TRUE
cbaddcacbcdccacbcdbcbdaddc	FALSE
bbcadcacaaccddcaadabacbdc	TRUE
cbcadcacaaccddcaadabacbdc	FALSE
bbcbdadbaaddcbcddbaaadabdb	TRUE
cbcbdadbaaddcbcddbaaadabdb	FALSE
bbccdaaaadbdacaadaccdcadb	TRUE
cbccdaaaadbdacaadaccdcadb	FALSE
bbcdccabcacaaabdccdbaabcdb	TRUE
cbcdccabcacaaabdccdbaabcdb	FALSE
bbdabdbabccabaabddabaabdab	TRUE
cbdabdbabccabaabddabaabdab	FALSE
bbdbcbadcaacdcdaadabdcdccc	TRUE
cbdbcbadcaacdcdaadabdcdccc	FALSE
bbdcbcbacbaadacbdbdaddacc	TRUE
cbdcbcbacbaadacbdbdaddacc	FALSE
bbddadbcacadaadbacbdbaacac	TRUE
cbddadbcacadaadbacbdbaacac	FALSE
bbaaadbcdbdbcbdacddcacbaac	TRUE
dbaaadbcdbdbcbdacddcacbaac	FALSE
bbabacaccdcddbaadbdaaccdcd	TRUE
dbabacaccdcddbaadbdaaccdcd	FALSE
bbacacadaaadaadaccddabacba	TRUE
dbacacadaaadaadaccddabacba	FALSE
bbadacacadbacccacabcaacbda	TRUE
dbadacacadbacccacabcaacbda	FALSE
bbaddcadcdbcdcdbcbcbcbdaca	TRUE
dbaddcadcdbcdcdbcbcbcbdaca	FALSE
bbcadcabcdbadabddadddbaddb	TRUE
dbcadcabcdbadabddadddbaddb	FALSE
bbcbdbdcaabaaaabaddcbcdbdb	TRUE
dbcbdbdcaabaaaabaddcbcdbdb	FALSE
bbcccdadcbcdaacbadbdadbdac	TRUE
dbcccdadcbcdaacbadbdadbdac	FALSE
bbcdcbdabdccdcbcdddcbcbccb	TRUE
dbcdcbdabdccdcbcdddcbcbccb	FALSE
bbdabdcbadbaccbdcdddbcdaa	TRUE
dbdabdcbadbaccbdcdddbcdaa	FALSE
bbdbcaadbccbdadcacbdcaadbd	TRUE
dbdbcaadbccbdadcacbdcaadbd	FALSE
bbdcbccbcadbdccabdacdcbadb	TRUE
dbdcbccbcadbdccabdacdcbadb	FALSE
bbddaddddcccadaddbcbdcaaaa	TRUE
dbddaddddcccadaddbcbdcaaaa	FALSE
caabbcbccbaaaddcaabddcabad	TRUE
caacbcbccbaaaddcaabddcabad	FALSE
cabbcdaabcbadcbdbcddbdbcab	TRUE
cadbcdaabcbadcbdbcddbdbcab	FALSE
cbbadaabcddababddbadadcabd	TRUE
cbadaabcddababddbadadcabd	FALSE
cbbdcdcddbcdddbccbadcbacdb	TRUE
cbdcdcddbcdddbccbadcbacdb	FALSE
cbbccccadaccbdcaddcddbabac	TRUE
cabccccadaccbdcaddcddbabac	FALSE
cbbabadbdbcaabcdadbdbcdbdd	TRUE
cbdbabadbdbcaabcdadbdbcdbdd	FALSE
cbbddbdbdcbaaadcaacaaadabd	TRUE
cbdddbdbdcbaaadcaacaaadabd	FALSE
cbbcadbadaababcddbddddbdca	TRUE
ccbcadbadaababcddbddddbdca	FALSE
cbbaabdbcbcacaaaccdbcdcbdc	TRUE
cdbaabdbcbcacaaaccdbcdcbdc	FALSE
cbbcdbdbccdcdbdaaadbcabdad	TRUE
cdbcdbdbccdcdbdaaadbcabdad	FALSE
ccbbcacbdbdaabdcdcccabdbdc	TRUE
ccabcacbdbdaabdcdcccabdbdc	FALSE
cccbbdaabcadccdbacdaadaddc	TRUE
cccdbdaabcadccdbacdaadaddc	FALSE
cdbbacacdabcccbabadbcdcbcb	TRUE
cdcbacacdabcccbabadbcdcbcb	FALSE
dabbcacccbadbcbaaacaaabcca	TRUE
dabcacccbadbcbaaacaaabcca	FALSE
dadabbdbacbadcbcbaaacbaaaa	TRUE
dadacbdbacbadcbcbaaacbaaaa	FALSE
dbbcbdaadacdbccbacdbdddbdb	TRUE
dbcbdaadacdbccbacdbdddbdb	FALSE
dbbaadacdaccddadddbabddbab	TRUE
dabaadacdaccddadddbabddbab	FALSE
dbbdadaababacabcdbddaaddb	TRUE
dabdadaababacabcdbddaaddb	FALSE
dbbcdbdbdddbaccdaabcaaccab	TRUE
dbcdbdbdddbaccdaabcaaccab	FALSE
dbbabccaddbcabccdbacdccbcb	TRUE
dcbabccaddbcabccdbacdccbcb	FALSE
dbbdbcbcadaaadccaacadbaadb	TRUE
dcbdbcbcadaaadccaacadbaadb	FALSE
dbbcbcbdbaddcdbdacaadaacac	TRUE
ddbcbcbdbaddcdbdacaadaacac	FALSE
dcacacbbccaabacdbcaaadccad	TRUE
dcacacabccaabacdbcaaadccad	FALSE
dcbbdbcaacdccccccacdbaddcb	TRUE
dccbdbcaacdccccccacdbaddcb	FALSE
ddbbddbaaaadacabcbcaccadcc	TRUE
ddbabddbaaaadacabcbcaccadcc	FALSE
aaaabbcbdccaaaddcababdbcbcdabab	TRUE
aaaaabcbdccaaaddcababdbcbcdabab	FALSE
aabbdbcabdadbadababacacdadaaacb	TRUE
aadbdbcabdadbadababacacdadaaacb	FALSE
abbaddcccbaadaddabdbcacbdcbdbaa	TRUE
abaddcccbaadaddabdbcacbdcbdbaa	FALSE
abbdccbcaddacadccbcdcdabaabcad	TRUE
abdccbcaddacadccbcdcdabaabcad	FALSE
abbccadcdbcdcaaadabcacdcdbdcbad	TRUE
aabccadcdbcdcaaadabcacdcdbdcbad	FALSE
abbdcadcbabccdbdbcaaabdaaabcddb	TRUE
abdbdcadcbabccdbdbcaaabdaaabcddb	FALSE
abdcbbaccbdcbabdabdadacdaabcddc	TRUE
abdcabaccbdcbabdabdadacdaabcddc	FALSE
abbdabddcdcabdbdacaccacdcadbad	TRUE
acbdabddcdcabdbdacaccacdcadbad	FALSE
abbcaadcaccaacabdcbdadbdddcacba	TRUE
adbcaadcaccaacabdcbdadbdddcacba	FALSE
acacdabbadbddcbacdabccdcabdaaa	TRUE
acacdadbadbddcbacdabccdcabdaaa	FALSE
accbbadbacbaddddababcaaabcacbad	TRUE
accbadbacbaddddababcaaabcacbad	FALSE
adbbabdddaadcdbdacddccddbcaaba	TRUE
adbababdddaadcdbdacddccddbcaaba	FALSE
bbaababdabdbdaccacbddccbcccbccb	TRUE
baababdabdbdaccacbddccbcccbccb	FALSE
bbababaadccbcdabdaaabcadaacdacb	TRUE
bababaadccbcdabdaaabcadaacdacb	FALSE
bbabddaadbaddbcbddaabdaddadccd	TRUE
babddaadbaddbcbddaabdaddadccd	FALSE
bbaccdcabcbddddaadaddadacbddcad	TRUE
baccdcabcbddddaadaddadacbddcad	FALSE
bbadccdcdccbabdcbcbadbcbadbcab	TRUE
badccdcdccbabdcbcbadbcbadbcab	FALSE
bbcacaaadbababacbccacacdcdbacba	TRUE
bcacaaadbababacbccacacdcdbacba	FALSE
bbcbccbabadcdaddbacbdcdabcdaada	TRUE
bcbccbabadcdaddbacbdcdabcdaada	FALSE
bbcccaccbdccdddbcdbcdbcacacdbca	TRUE
bcccaccbdccdddbcdbcdbcacacdbca	FALSE
bbcdbdcbabacadddcabdbddaadcaba	TRUE
bcdbdcbabacadddcabdbddaadcaba	FALSE
bbdabaabddbacccbdabcbabcbcdcccb	TRUE
bdabaabddbacccbdabcbabcbcdcccb	FALSE
bbdbacdbaadbaddbdccadabcdddbabd	TRUE
bdbacdbaadbaddbdccadabcdddbabd	FALSE
bbdcabadacbcaabaadcbabdacbaabad	TRUE
bdcabadacbcaabaadcbabdacbaabad	FALSE
bbddabdcaadabaacccbcbcdbababcb	TRUE
bddabdcaadabaacccbcbcdbababcb	FALSE
bbdddbcdbdccdccccadbcabaccdccaa	TRUE
bdddbcdbdccdccccadbcabaccdccaa	FALSE
bbaacddacabacbacdbcdcadcadbcdb	TRUE
abaacddacabacbacdbcdcadcadbcdb	FALSE
bbabcdbcbdcddbadabdcaaddcdcbdab	TRUE
ababcdbcbdcddbadabdcaaddcdcbdab	FALSE
bbaccccbcbdadcacbdabcbcacadabdd	TRUE
abaccccbcbdadcacbdabcbcacadabdd	FALSE
bbadccbccbcabcbdbddccdadacdabdc	TRUE
abadccbccbcabcbdbddccdadacdabdc	FALSE
bbcacaaccaacabccbabccaddcbdaba	TRUE
abcacaaccaacabccbabccaddcbdaba	FALSE
bbcbcbdbdbcbcdcdbadbcccddcacbaa	TRUE
abcbcbdbdbcbcdcdbadbcccddcacbaa	FALSE
bbcccbcdaaacdaddccbcbcdbadbdaca	TRUE
abcccbcdaaacdaddccbcbcdbadbdaca	FALSE
bbcdcbcaddaaabdbdddbcaaaaabdbab	TRUE
abcdcbcaddaaabdbdddbcaaaaabdbab	FALSE
bbdaccdddaccbccaabccbabcabdcbca	TRUE
abdaccdddaccbccaabccbabcabdcbca	FALSE
bbdbcddcdaaabaacbadaacaaabaccba	TRUE
abdbcddcdaaabaacbadaacaaabaccba	FALSE
bbdccdaaabdccabacadabdbaaaddbd	TRUE
abdccdaaabdccabacadabdbaaaddbd	FALSE
bbddccabdcacacbcadadabcacdaaacc	TRUE
abddccabdcacacbcadadabcacdaaacc	FALSE
bbcbadbdadcddddbccdcdddddacaaad	TRUE
babcbadbdadcddddbccdcdddddacaaad	FALSE
bbadcadcbaacbdadaddbdbcddcdaccc	TRUE
bcbadcadcbaacbdadaddbdbcddcdaccc	FALSE
bbabadcbdcccacacabccacaadacccbc	TRUE
bdbabadcbdcccacacabccacaadacccbc	FALSE
bbddcadcabddbababdaccadbcdaadb	TRUE
bdbddcadcabddbababdaccadbcdaadb	FALSE
badbbdbadcdccabcbaaacabcdbcbdb	TRUE
badbdbadcdccabcbaaacabcdbcbdb	FALSE
bbdadacbadcdbdaabdcaabccdbaabab	TRUE
bdadacbadcdbdaabdcaabccdbaabab	FALSE
bbbdbdbadbccadcaccdcdbdbadddba	TRUE
babdbdbadbccadcaccdcdbdbadddba	FALSE
bbbaddbccbababcdcdcabcdbabacdba	TRUE
bcbaddbccbababcdcdcabcdbabacdba	FALSE
bbbcbdbcbcddcbacadcbccacadbabd	TRUE
bdbcbdbcbcddcbacadcbccacadbabd	FALSE
bcbbaaddaccbdbdcaabadaccbacbaaa	TRUE
bcbaaddaccbdbdcaabadaccbacbaaa	FALSE
bccbdbbabddcbdadacabcbdaadbddba	TRUE
bccbddbabddcbdadacabcbdaadbddba	FALSE
bdbbaabdaabdbddddabdabaddbdcaac	TRUE
bdcbaabdaabdbddddabdabaddbdcaac	FALSE
bbaabccbacbccdccdbcccdabaaddaad	TRUE
cbaabccbacbccdccdbcccdabaaddaad	FALSE
bbabccbadcbabacdcbaadcdabdcbdcc	TRUE
cbabccbadcbabacdcbaadcdabdcbdcc	FALSE
bbaccabdcdcbdbaacaaadcbabaadbc	TRUE
cbaccabdcdcbdbaacaaadcbabaadbc	FALSE
bbadbcccaabccabdcdbcacbcdbcaaba	TRUE
cbadbcccaabccabdcdbcacbcdbcaaba	FALSE
bbcabacbcbacabdcacacbcdcbdbabab	TRUE
cbcabacbcbacabdcacacbcdcbdbabab	FALSE
bbcbaddcbdcdbddccadcdbabadbccc	TRUE
cbcbaddcbdcdbddccadcdbabadbccc	FALSE
bbccbacbcddbdcbadacaddbabcaabdc	TRUE
cbccbacbcddbdcbadacaddbabcaabdc	FALSE
bbcdbadbadbcadcbdcddbdcdaccdcbc	TRUE
cbcdbadbadbcadcbdcddbdcdaccdcbc	FALSE
bbdabadcaaccacdbabacabaadbabcdb	TRUE
cbdabadcaaccacdbabacabaadbabcdb	FALSE
bbdbacbdaaddaddacbdcaddbcabacaa	TRUE
cbdbacbdaaddaddacbdcaddbcabacaa	FALSE
bbdcbcabddaccdabdbaacdacbdddbac	TRUE
cbdcbcabddaccdabdbaacdacbdddbac	FALSE
bbddbacabaaacdacdbcddcaadcacbaa	TRUE
cbddbacabaaacdacdbcddcaadcacbaa	FALSE
bbaaacabcadbccbcaccdbaadbccdaad	TRUE
dbaaacabcadbccbcaccdbaadbccdaad	FALSE
bbabaacaccbabcbdcbcaddbcbdadbcb	TRUE
dbabaacaccbabcbdcbcaddbcbdadbcb	FALSE
bbabddbcaaccbabaadadcaccccdddd	TRUE
dbabddbcaaccbabaadadcaccccdddd	FALSE
bbacddbddcdbabcbadddaadccabdca	TRUE
dbacddbddcdbabcbadddaadccabdca	FALSE
bbaddbccbcbaadaddacdcbcdcbccbd	TRUE
dbaddbccbcbaadaddacdcbcdcbccbd	FALSE
bbcbaaabdabcacbadddbacabdaaccaa	TRUE
dbcbaaabdabcacbadddbacabdaaccaa	FALSE
bbcbddbabaaaadddadbcbadbcbabccb	TRUE
dbcbddbabaaaadddadbcbadbcbabccb	FALSE
bbccddaaddadbdadaacabccbcbcaacc	TRUE
dbccddaaddadbdadaacabccbcbcaacc	FALSE
bbcddccbcbdcaaddbddcbcabadccbad	TRUE
dbcddccbcbdcaaddbddcbcabadccbad	FALSE
bbdadaccbddbdcbcdcaccdbcabdacad	TRUE
dbdadaccbddbdcbcdcaccdbcabdacad	FALSE
bbdbdbcdbdccbabcbabcdcbcccadabd	TRUE
dbdbdbcdbdccbabcbabcdcbcccadabd	FALSE
bbdcddabdbcaaccdcaaddccdbababc	TRUE
dbdcddabdbcaaccdcaaddccdbababc	FALSE
bbdddbaabdbdababcbdacccbadbddc	TRUE
dbdddbaabdbdababcbdacccbadbddc	FALSE
cabbadcdaabcddaadcbadbcabcbccdd	TRUE
cacbadcdaabcddaadcbadbcabcbccdd	FALSE
cbbacaddbcdabdbdbcdbadcbaaddccc	TRUE
cbacaddbcdabdbdbcdbadcbaaddccc	FALSE
cbbdbababcbdabdcabdcbcbdacaaaac	TRUE
cbdbababcbdabdcabdcbcbdacaaaac	FALSE
cbbcadcdabadbdddccbdaadcaddbcd	TRUE
cabcadcdabadbdddccbdaadcaddbcd	FALSE
cbbdddacbdddbcddbccdbdbddccaba	TRUE
cabdddacbdddbcddbccdbdbddccaba	FALSE
cbbcddcbdddbccbaddbcdbccbacbaab	TRUE
cbacddcbdddbccbaddbcdbccbacbaab	FALSE
cbbadcbcdabccaaccaabdcadcbccbda	TRUE
ccbadcbcdabccaaccaabdcadcbccbda	FALSE
cbbdcdbacaaadcaabcabccbdabcbccc	TRUE
ccbdcdbacaaadcaabcabccbdabcbccc	FALSE
cbbcbdabdbdaaabdcdcdccbdcccdccd	TRUE
cdbcbdabdbdaaabdcdcdccbdcccdccd	FALSE
ccbbabadbadbacaccbadbcadbdadba	TRUE
ccbabadbadbacaccbadbcadbdadba	FALSE
cccbbacbdcbaacdcabdaabababadbdd	TRUE
cccdbacbdcbaacdcabdaabababadbdd	FALSE
cdbbacadbcdcbadbddbcbcaccbdddba	TRUE
cdcbacadbcdcbadbddbcbcaccbdddba	FALSE
dabbcacbacababcdddabaddcabcabab	TRUE
dabcacbacababcdddabaddcabcabab	FALSE
dacbbccdcadaabcdcabcaaccbacbcdd	TRUE
dacbccdcadaabcdcabcaaccbacbcdd	FALSE
dbbcacccdaccacadcabaacadadbaaac	TRUE
dbcacccdaccacadcabaacadadbaaac	FALSE
dbbddadaabdacabaabdabacbccabcad	TRUE
dbddadaabdacabaabdabacbccabcad	FALSE
dbbcccccccbdcbddccddbacccaacdac	TRUE
dabcccccccbdcbddccddbacccaacdac	FALSE
dbbdaaacaadacccaacacdbddcddddcd	TRUE
dbcbdaaacaadacccaacacdbddcddddcd	FALSE
dbbacadacabcbdaddcdbdacdcbcccd	TRUE
dbdacadacabcbdaddcdbdacdcbcccd	FALSE
dbbadcabdbabdcdcbdcdaabddcccbda	TRUE
dcbadcabdbabdcdcbdcdaabddcccbda	FALSE
dbbaaabcccadddccabdacabccaadaad	TRUE
ddbaaabcccadddccabdacabccaadaad	FALSE
dbbcdcccbdacdcaacabdcdccbcadcbc	TRUE
ddbcdcccbdacdcaacabdcdccbcadcbc	FALSE
dcbbadaddcaabaddacddbadcccbabda	TRUE
dcabadaddcaabaddacddbadcccbabda	FALSE
dccbbdbcbaaddcbddbcbaacbcbdbaca	TRUE
dccdbdbcbaaddcbddbcbaacbcbdbaca	FALSE
ddbbccdddcddbcabacbdacabdabcbca	TRUE
ddbdbccdddcddbcabacbdacabdabcbca	FALSE
aaaabbdcaccabadcaaabadcacbcadcdaaca	TRUE
aaaabdcaccabadcaaabadcacbcadcdaaca	FALSE
aabbcbdbcbdcdccdaaadcdddbdcadaaacbcc	TRUE
aadbcbdbcbdcdccdaaadcdddbdcadaaacbcc	FALSE
abbadcdadbadbdcaccdbdcccddbccccdcbdd	TRUE
abadcdadbadbdcaccdbdcccddbccccdcbdd	FALSE
abbddbdaaddbcabdbacbadbcadbdbaadcaad	TRUE
abddbdaaddbcabdbacbadbcadbdbaadcaad	FALSE
abbccdaccbcddabcbabddcacdcabcbacddcd	TRUE
aabccdaccbcddabcbabddcacdcabcbacddcd	FALSE
abbccacdacbdcabdcdadaccbdadacbabdcca	TRUE
abdbccacdacbdcabdcdadaccbdadacbabdcca	FALSE
abccbbcbcbcdbaabcbcccacdadadbaabdbc	TRUE
abccbcbcbcbcdbaabcbcccacdadadbaabdbc	FALSE
abbdaacbaacbdccdbdaccaccccccddbcccbd	TRUE
acbdaacbaacbdccdbdaccaccccccddbcccbd	FALSE
abbaddccdcacddaabacbadcaaccbccbacca	TRUE
adbaddccdcacddaabacbadcaaccbccbacca	FALSE
abbdddbdabadadabdbacbacaaacbaabaacb	TRUE
adbdddbdabadadabdbacbacaaacbaabaacb	FALSE
acbcbbdddddaaccabcbaaccaddcbdbabddc	TRUE
acbcdbdddddaaccabcbaaccaddcbdbabddc	FALSE
adbbcaacadaccabddbdbcddcccbadcbaddcd	TRUE
adbcaacadaccabddbdbcddcccbadcbaddcd	FALSE
addbbdddddbcaadccbaaacbdadadcbdddaba	TRUE
adddbdddddbcaadccbaaacbdadadcbdddaba	FALSE
bbaadcbdbccadabcaadcbcadcbcbdcbaccbc	TRUE
baadcbdbccadabcaadcbcadcbcbdcbaccbc	FALSE
bbabdcbccdcadbcdcbdcdaddbddababdaada	TRUE
babdcbccdcadbcdcbdcdaddbddababdaada	FALSE
bbacdabadbdaddadcbaacaadddbadcdcdbaa	TRUE
bacdabadbdaddadcbaacaadddbadcdcdbaa	FALSE
bbadcbdccdbacbacdbddbdbdccadcaccadbd	TRUE
badcbdccdbacbacdbddbdbdccadcaccadbd	FALSE
bbcabdaadbcadacaaaabcbadbcaaadcdaabd	TRUE
bcabdaadbcadacaaaabcbadbcaaadcdaabd	FALSE
bbcbcbcccacdddbddbcaccdcccddcabacab	TRUE
bcbcbcccacdddbddbcaccdcccddcabacab	FALSE
bbccbdccbdcaadacabadaadbdcaccbaaabaa	TRUE
bccbdccbdcaadacabadaadbdcaccbaaabaa	FALSE
bbcdcadabadcdcccabccbaadcaccbcabaacd	TRUE
bcdcadabadcdcccabccbaadcaccbcabaacd	FALSE
bbdacbddadcccbcbdbdadddcdbdddccbccaa	TRUE
bdacbddadcccbcbdbdadddcdbdddccbccaa	FALSE
bbdbcccbabacdabdddddaabaacabdbadcbc	TRUE
bdbcccbabacdabdddddaabaacabdbadcbc	FALSE
bbdcbdcbcbdbcddcbcccdbdcbabcacbadcbd	TRUE
bdcbdcbcbdbcddcbcccdbdcbabcacbadcbd	FALSE
bbddbdcabccdababdabcbaabdcbaaababcdd	TRUE
bddbdcabccdababdabcbaabdcbaaababcdd	FALSE
bbaaccadaccbaabcddbadbcbaddcbddababd	TRUE
abaaccadaccbaabcddbadbcbaddcbddababd	FALSE
bbabccadbcbdcdcbcabacadcdabcbabddcd	TRUE
ababccadbcbdcdcbcabacadcdabcbabddcd	FALSE
bbacbcccdcbacabadcdbabaddddcdcdcbaba	TRUE
abacbcccdcbacabadcdbabaddddcdcdcbaba	FALSE
bbadbdacadbdbdcdccdaacabaabdcdbcdccd	TRUE
abadbdacadbdbdcdccdaacabaabdcdbcdccd	FALSE
bbcabdacdbaacbcadbcdccaabcbccccbcdcc	TRUE
abcabdacdbaacbcadbcdccaabcbccccbcdcc	FALSE
bbcbadadaadaccccdacbadabcbdcadbadbcd	TRUE
abcbadadaadaccccdacbadabcbdcadbadbcd	FALSE
bbccadbcabcbcdbcbcbaddcaacbddabcbdb	TRUE
abccadbcabcbcdbcbcbaddcaacbddabcbdb	FALSE
bbcdadbcccbadbcadddddababcdbcdcdbabd	TRUE
abcdadbcccbadbcadddddababcdbcdcdbabd	FALSE
bbdaabcbaabacacadbdcbaabdcdbcdbaadbd	TRUE
abdaabcbaabacacadbdcbaabdcdbcdbaadbd	FALSE
bbdbaabacdcccdbabdaddbcabcbcbcadabab	TRUE
abdbaabacdcccdbabdaddbcabcbcbcadabab	FALSE
bbdcabaacddcadadcacbcadccddbcaddbcaa	TRUE
abdcabaacddcadadcacbcadccddbcaddbcaa	FALSE
bbddacccddbdbcdcadbabcaaaccdddaccccd	TRUE
abddacccddbdbcdcadbabcaaaccdddaccccd	FALSE
bbabacdcccbdbdcdcbdbcddcabcbddcadcad	TRUE
bababacdcccbdbdcdcbdbcddcabcbddcadcad	FALSE
bbdddadcacdadacacabccaccccdcbcacccad	TRUE
babdddadcacdadacacabccaccccdcbcacccad	FALSE
bbdbabcdaabdacbcbabcaaaccabdacccdbad	TRUE
bcbdbabcdaabdacbcbabcaaaccabdacccdbad	FALSE
bbcbdccaddbdaaddabcccbacdacdcbdbacdc	TRUE
bdbcbdccaddbdaaddabcccbacdacdcbdbacdc	FALSE
babbccbdadbcbcdbabdcdbddbddbcbdcaadd	TRUE
baabccbdadbcbcdbabdcdbddbddbcbdcaadd	FALSE
bbabadbacacdcdadcdaacbdbddaadddcccbc	TRUE
babadbacacdcdadcdaacbdbddaadddcccbc	FALSE
bbdacbcaaadacccaaadcbcdabddbdaaabcd	TRUE
bdacbcaaadacccaaadcbcdabddbdaaabcd	FALSE
bbbdcabdaabcdbcaabcbaddccbdbabddccbc	TRUE
babdcabdaabcdbcaabcbaddccbdbabddccbc	FALSE
bbadababcbcbabccbdababcaadbacddcbcd	TRUE
bcadababcbcbabccbdababcaadbacddcbcd	FALSE
bbdcbcdbdabcbdaddbdbabacdbdbacacbdad	TRUE
bcdcbcdbdabcbdaddbdbabacdbdbacacbdad	FALSE
bbccbccaddcdabcadcbdcdabcaadcccbdddd	TRUE
bdccbccaddcdabcadcbdcdabcaadcccbdddd	FALSE
bcbdbbdabacacddaaccaccbdaababdabdcdc	TRUE
bcbdabdabacacddaaccaccbdaababdabdcdc	FALSE
bdbbcdcabddbabcddadaabdcdabcccbabadd	TRUE
bdabcdcabddbabcddadaabdcdabcccbabadd	FALSE
bbaaadacdabaacdbddbaddbacdcdacdbcdaa	TRUE
cbaaadacdabaacdbddbaddbacdcdacdbcdaa	FALSE
bbaadcbdcdadaddccdabaddccbcdddaacdcc	TRUE
cbaadcbdcdadaddccdabaddccbcdddaacdcc	FALSE
bbabdbddbacadccbaaccdcbcabcddbcadac	TRUE
cbabdbddbacadccbaaccdcbcabcddbcadac	FALSE
bbaccbddbadbcbabcdadcadccdadaddadaba	TRUE
cbaccbddbadbcbabcdadcadccdadaddadaba	FALSE
bbadcbacdcbdcdacddbacddbadcdaacaacba	TRUE
cbadcbacdcbdcdacddbacddbadcdaacaacba	FALSE
bbcadababcbabdcdacdbdabccacacccacdbd	TRUE
cbcadababcbabdcdacdbdabccacacccacdbd	FALSE
bbcbcdbdbcbaacabcdbdcaaddcadaacddbcd	TRUE
cbcbcdbdbcbaacabcdbdcaaddcadaacddbcd	FALSE
bbcccaabcaddaddcbccbabdcccacccddcbda	TRUE
cbcccaabcaddaddcbccbabdcccacccddcbda	FALSE
bbcdbddddaaaabddcbadddacabdabaddddcb	TRUE
cbcdbddddaaaabddcbadddacabdabaddddcb	FALSE
bbdabdaaacccbddaccbabaaababcddcbdba	TRUE
cbdabdaaacccbddaccbabaaababcddcbdba	FALSE
bbdbcaaddbcbcdcccdacbcacaabdcbccdddb	TRUE
cbdbcaaddbcbcdcccdacbcacaabdcbccdddb	FALSE
bbdcbaaaacbaadadbdbccbcbcdaaadcaccbd	TRUE
cbdcbaaaacbaadadbdbccbcbcdaaadcaccbd	FALSE
bbddacdddadcaabcccddcbcbddbdbdaabaca	TRUE
cbddacdddadcaabcccddcbcbddbdbdaabaca	FALSE
bbaaacabcdbabadacdbcbacdbadacadccbdb	TRUE
dbaaacabcdbabadacdbcbacdbadacadccbdb	FALSE
bbaaddbdaddddaabaaccddbdccdadacbaacd	TRUE
dbaaddbdaddddaabaaccddbdccdadacbaacd	FALSE
bbabdbcbaabcbccccdacaddcbccbccabaaac	TRUE
dbabdbcbaabcbccccdacaddcbccbccabaaac	FALSE
bbaccdcbabcddcdadabddadcbcddadccbaac	TRUE
dbaccdcbabcddcdadabddadcbcddadccbaac	FALSE
bbadccdbcdcadbdbaccdbaacbdccddadadbd	TRUE
dbadccdbcdcadbdbaccdbaacbdccddadadbd	FALSE
bbcacaccabccbddcdbdccbdddacdaaabcccd	TRUE
dbcacaccabccbddcdbdccbdddacdaaabcccd	FALSE
bbcbcbdbdadbddbdcacabddaccdbddcbaadb	TRUE
dbcbcbdbdadbddbdcacabddaccdbddcbaadb	FALSE
bbccbcdddbcaabcacbccddcbadbcabcaddba	TRUE
dbccbcdddbcaabcacbccddcbadbcabcaddba	FALSE
bbcdbccaacbcaccbcccabddccbdbacdaabad	TRUE
dbcdbccaacbcaccbcccabddccbdbacdaabad	FALSE
bbdabdacbcbcabdbaccaccbabdddbdacbdab	TRUE
dbdabdacbcbcabdbaccaccbabdddbdacbdab	FALSE
bbdbcadddbcdbcdbcbdbaacbdbdaddaadcab	TRUE
dbdbcadddbcdbcdbcbdbaacbdbdaddaadcab	FALSE
bbdcbcbaaaabababadddabcccdddbdddbcdb	TRUE
dbdcbcbaaaabababadddabcccdddbdddbcdb	FALSE
bbddbcbdadbdaddcdcdcaacaadaabddccdaa	TRUE
dbddbcbdadbdaddcdcdcaacaadaabddccdaa	FALSE
cabbcdcbaacdcacbabcadabdcdbdbddacdda	TRUE
cabcdcbaacdcacbabcadabdcdbdbddacdda	FALSE
cacbbddcacaacddcbabcccacdccdddccbcbc	TRUE
caccbddcacaacddcbabcccacdccdddccbcbc	FALSE
cbbcbdcaabacabcbdbabcccccacdcbcaaad	TRUE
cbcbdcaabacabcbdbabcccccacdcbcaaad	FALSE
cbbaaddddacbcccddddbcdacaaadcdadabac	TRUE
cabaaddddacbcccddddbcdacaaadcdadabac	FALSE
cbbdbccabcdbabdacdcbacacbaabaaababdd	TRUE
cabdbccabcdbabdacdcbacacbaabaaababdd	FALSE
cbbabccbccaabdcbdacbcaddacbcdbabaab	TRUE
cbabccbccaabdcbdacbcaddacbcdbabaab	FALSE
cbbaacddcaddcaccdcaacabaacbadacbcdda	TRUE
ccbaacddcaddcaccdcaacabaacbadacbcdda	FALSE
cbbccddbadddcbcaddcbdcaababccbadcdcc	TRUE
ccbccddbadddcbcaddcbdcaababccbadcdcc	FALSE
cbbadaaadabadcdcadbacbcadabcbdabdac	TRUE
cdbadaaadabadcdcadbacbcadabcbdabdac	FALSE
cbbddaacddddccaaabacadccdbcdccaddbcd	TRUE
cdbddaacddddccaaabacadccdbcdccaddbcd	FALSE
ccbbaddbdcadbdcddcacdcdcaaabcccdbcad	TRUE
cccbaddbdcadbdcddcacdcdcaaabcccdbcad	FALSE
cdbbadadccabaaacddcbccbdbdbcbcccacda	TRUE
cdabadadccabaaacddcbccbdbdbcbcccacda	FALSE
cddddbbdaaddccdabdcadadabaabababcabc	TRUE
cddddabdaaddccdabdcadadabaabababcabc	FALSE
dabbdcacccdbccdcbabccdadddcbcddbacd	TRUE
dacbdcacccdbccdcbabccdadddcbcddbacd	FALSE
dbbcabaccabddabcabcbccaddadadababcba	TRUE
dbcabaccabddabcabcbccaddadadababcba	FALSE
dbbaabccadddddccddaaacbcabdbccbddadb	TRUE
dabaabccadddddccddaaacbcabdbccbddadb	FALSE
dbbdacaddaabcadadbaaabcdaabcbcdcdab	TRUE
dabdacaddaabcadadbaaabcdaabcbcdcdab	FALSE
dbabbadbdaabaaabccabdccbdadabcbccbcb	TRUE
dbacbadbdaabaaabccabdccbdadabcbccbcb	FALSE
dbdbbdaaddddbadccaddbdaaacdacacacbcc	TRUE
dbdabdaaddddbadccaddbdaaacdacacacbcc	FALSE
dbbdabdbdccdbdababdadcbdbadcbdbdcccc	TRUE
dcbdabdbdccdbdababdadcbdbadcbdbdcccc	FALSE
dbbadcbcbccdbdbdccbaaddbdbdadcddadbc	TRUE
ddbadcbcbccdbdbdccbaaddbdbdadcddadbc	FALSE
dcaacccbbabdbccdaccaadbddaaabccadbc	TRUE
dcaaccccbabdbccdaccaadbddaaabccadbc	FALSE
dcbbccadacbccacbddccddcabdaabcacdccc	TRUE
dcdbccadacbccacbddccddcabdaabcacdccc	FALSE
ddbbcaaababadbaddbcabcaadcbdbadbdbad	TRUE
ddabcaaababadbaddbcabcaadcbdbadbdbad	FALSE
aaaabbdcbdacaddabddaadadcbdbaaaccaaabaada	TRUE
aaaabdcbdacaddabddaadadcbdbaaaccaaabaada	FALSE
aabbdbcbdbdcadbcbabadbcbacdccadacbdbccbac	TRUE
aacbdbcbdbdcadbcbabadbcbacdccadacbdbccbac	FALSE
abbacddcaadcacbcaaddbddbabddacdabdcdaddb	TRUE
abacddcaadcacbcaaddbddbabddacdabdcdaddb	FALSE
abbddacacdbadbacccbccabaaaaaacdcbaadaaccc	TRUE
abddacacdbadbacccbccabaaaaaacdcbaadaaccc	FALSE
abbccddababaabccabdbdbacaadccabababaaddab	TRUE
aabccddababaabccabdbdbacaadccabababaaddab	FALSE
abbcabdadbdbdddadbadacadbdbddadacbcaccddc	TRUE
abdbcabdadbdbdddadbadacadbdbddadacbcaccddc	FALSE
abccbbccdcabababddcbcdaabdabcaccbdacdddad	TRUE
abcccbccdcabababddcbcdaabdabcaccbdacdddad	FALSE
abbccbdbdddbccddcbcbccdacccddbabaaaabdabc	TRUE
acbccbdbdddbccddcbcbccdacccddbabaaaabdabc	FALSE
abbabcababcdddadadbdddcdacdcbdadcabcdcddc	TRUE
adbabcababcdddadadbdddcdacdcbdadcabcdcddc	FALSE
abbdabcaaadacdbdbabdccdbacbadcddddbabcaa	TRUE
adbdabcaaadacdbdbabdccdbacbadcddddbabcaa	FALSE
acbbcdcdaaaaadbddaaadbdcdabacaabcabcbcdbc	TRUE
acbcdcdaaaaadbddaaadbdcdabacaabcabcbcdbc	FALSE
acccabbabdcdabdacadddbcacdbcadcdbadddaba	TRUE
acccabdabdcdabdacadddbcacdbcadcdbadddaba	FALSE
adbdbbaacbdaadbabdccbacdabaccbaacabdcadda	TRUE
adbdcbaacbdaadbabdccbacdabaccbaacabdcadda	FALSE
bbaaacbadbadccbdaacacccdcadddaccdcdbcdacb	TRUE
baaacbadbadccbdaacacccdcadddaccdcdbcdacb	FALSE
bbaaddbcdcadaabcaddbccabccabaacabaccdcadd	TRUE
baaddbcdcadaabcaddbccabccabaacabaccdcadd	FALSE
bbabdbcdccbcacbdacccdadddcabdddbacadbcca	TRUE
babdbcdccbcacbdacccdadddcabdddbacadbcca	FALSE
bbacdadcaccbcdabdcbaaacbcdbddadcdadcbccca	TRUE
bacdadcaccbcdabdcbaaacbcdbddadcdadcbccca	FALSE
bbaddbacbadbdabcabacdadbddcaabdadadaacac	TRUE
baddbacbadbdabcabacdadbddcaabdadadaacac	FALSE
bbcacdaadccccddddbcdaaacccccadbaacbdacacc	TRUE
bcacdaadccccddddbcdaaacccccadbaacbdacacc	FALSE
bbcbdbdbaacbaccbccdbcbcbdacbdbdbacdccbadd	TRUE
bcbdbdbaacbaccbccdbcbcbdacbdbdbacdccbadd	FALSE
bbccccaccbdbcdcbdadbdcbdadbabdbaabcdabaac	TRUE
bccccaccbdbcdcbdadbdcbdadbabdbaabcdabaac	FALSE
bbcdcbccdcccdacabcbdacaadaccbababccbdbcbd	TRUE
bcdcbccdcccdacabcbdacaadaccbababccbdbcbd	FALSE
bbdacadccabdacbadbccdbacadccdddcdaabadcad	TRUE
bdacadccabdacbadbccdbacadccdddcdaabadcad	FALSE
bbdbccbdbcaccabcbdadcabcdbacdbcbcddbcbdac	TRUE
bdbccbdbcaccabcbdadcabcdbacdbcbcddbcbdac	FALSE
bbdcbccbaccddacadcbccbaddaacdcabcbcccddcd	TRUE
bdcbccbaccddacadcbccbaddaacdcabcbcccddcd	FALSE
bbddbabdbdddbcababdaddaaadbcdbdadcccbcaab	TRUE
bddbabdbdddbcababdaddaaadbcdbdadcccbcaab	FALSE
bbaabaadbcbacdbcdbcaccacaaacbaaccaddbabad	TRUE
abaabaadbcbacdbcdbcaccacaaacbaaccaddbabad	FALSE
bbababcddaadadccbdbabdaacddaddbcccdbadaa	TRUE
abababcddaadadccbdbabdaacddaddbcccdbadaa	FALSE
bbacbacbabdbcaaddbadbdcaaabadccbcddcaccad	TRUE
abacbacbabdbcaaddbadbdcaaabadccbcddcaccad	FALSE
bbadadbabcaacdbdababdbdcacbabcbcacdacdddb	TRUE
abadadbabcaacdbdababdbdcacbabcbcacdacdddb	FALSE
bbcaadcddaccbcaadadbdbaabcdcccbcbccdabac	TRUE
abcaadcddaccbcaadadbdbaabcdcccbcbccdabac	FALSE
bbcbabddaacddbdddacbaddabcbdbdcadbadbabda	TRUE
abcbabddaacddbdddacbaddabcbdbdcadbadbabda	FALSE
bbccabaddccbcbcadbadbdabadbabcdbcddcadcad	TRUE
abccabaddccbcbcadbadbdabadbabcdbcddcadcad	FALSE
bbcdacdaaddacdaabcbdcabdbabdddccdababaac	TRUE
abcdacdaaddacdaabcbdcabdbabdddccdababaac	FALSE
bbdababcbdcddadadddbabdbdcbaacbcddacbabdc	TRUE
abdababcbdcddadadddbabdbdcbaacbcddacbabdc	FALSE
bbdbabdccabaddadcadadbcadbdadaabdbdbcaadc	TRUE
abdbabdccabaddadcadadbcadbdadaabdbdbcaadc	FALSE
bbdcaaadcccabcbaadcbaccddacadabcbcaaccdc	TRUE
abdcaaadcccabcbaadcbaccddacadabcbcaaccdc	FALSE
bbdcdcccabcddcdbaddacbdbacabababcbaddbcd	TRUE
abdcdcccabcddcdbaddacbdbacabababcbaddbcd	FALSE
bbdddccbcdbaaadadbaccababaabdacbdadcddba	TRUE
abdddccbcdbaaadadbaccababaabdacbdadcddba	FALSE
bbdaaaddadbdabdaddcbcabacdcaccbacbaacbada	TRUE
babdaaaddadbdabdaddcbcabacdcaccbacbaacbada	FALSE
bbccababdbcacdbddcabdacbcabaacadddadcadca	TRUE
bcbccababdbcacdbddcabdacbcabaacadddadcadca	FALSE
bbacbdaabdbdbccaacbccdadcaaababcacacabdcc	TRUE
bdbacbdaabdbdbccaacbccdadcaaababcacacabdcc	FALSE
bbddaccaacacbadcbcbcdbabacaacddbaabadaaac	TRUE
bdbddaccaacacbadcbcbcdbabacaacddbaabadaaac	FALSE
babbaccbdadabaccaabdcbcdddccaabcdbcddbabc	TRUE
badbaccbdadabaccaabdcbcdddccaabcdbcddbabc	FALSE
bbcaadcadaabacbddbaddbdcabdcdcbcaaadbdac	TRUE
bcaadcadaabacbddbaddbdcabdcdcbcaaadbdac	FALSE
bbabccdaacdbabdbadaaaccabaacbdbcddcbcddbc	TRUE
baabccdaacdbabdbadaaaccabaacbdbcddcbcddbc	FALSE
bbdddcbacaabcaacbcacdbcdcbccdaaccddaaadab	TRUE
badddcbacaabcaacbcacdbcdcbccdaaccddaaadab	FALSE
bbcdadabadadaccdcccbabdcccadccadcbabddcdb	TRUE
bccdadabadadaccdcccbabdcccadccadcbabddcdb	FALSE
bbcbadabcadbdaddcddbcbaabcdaccaacdaccabdd	TRUE
bdcbadabcadbdaddcddbcbaabcdaccaacdaccabdd	FALSE
bcbbabccadddbadccccdaadbdcbdacdcacaccbdcc	TRUE
bccbabccadddbadccccdaadbdcbdacdcacaccbdcc	FALSE
bdabbabdabacbdaacadabcbdcbcadccbadddabcaa	TRUE
bdacbabdabacbdaacadabcbdcbcadccbadddabcaa	FALSE
bddbacabbddbacdacdcccdddccdccabcadbcacacc	TRUE
bddbacacbddbacdacdcccdddccdccabcadbcacacc	FALSE
bbabaabdacbdccbcbcabaaccababdabdadcadbccb	TRUE
cbabaabdacbdccbcbcabaaccababdabdadcadbccb	FALSE
bbacadbcaabcccabccabdddaaddabcbcbaacabdda	TRUE
cbacadbcaabcccabccabdddaaddabcbcbaacabdda	FALSE
bbadbaccccddddadcacddcccacbdbddbdcccdcacb	TRUE
cbadbaccccddddadcacddcccacbdbddbdcccdcacb	FALSE
bbcaadabdaacacabcaddbdbccacbcbddaaadbdaac	TRUE
cbcaadabdaacacabcaddbdbccacbcbddaaadbdaac	FALSE
bbcbaaccaacddcbcaabaccadcdadbcacdcaaadcad	TRUE
cbcbaaccaacddcbcaabaccadcdadbcacdcaaadcad	FALSE
bbccabadccddbabcddabdcdcbaacbcddaabcccaca	TRUE
cbccabadccddbabcddabdcdcbaacbcddaabcccaca	FALSE
bbcdaadbdcbdcddacdccbdbabdbccdacacbcabdaa	TRUE
cbcdaadbdcbdcddacdccbdbabdbccdacacbcabdaa	FALSE
bbdaaabacaaabcbdabdaddcbcdbcdddabaadbcdc	TRUE
cbdaaabacaaabcbdabdaddcbcdbcdddabaadbcdc	FALSE
bbdaddddbdccaddbcdcbdabcaababcbddaccadaac	TRUE
cbdaddddbdccaddbcdcbdabcaababcbddaccadaac	FALSE
bbdcabacddaacdcbdbcbddcadcbabaabababaddcb	TRUE
cbdcabacddaacdcbdbcbddcadcbabaabababaddcb	FALSE
bbdcddabcdccdbcababdaddbcdaabccccdbabccb	TRUE
cbdcddabcdccdbcababdaddbcdaabccccdbabccb	FALSE
bbdddcdaadabaacacdbdabdbacbcbcbabdccdcddd	TRUE
cbdddcdaadabaacacdbdabdbacbcbcbabdccdcddd	FALSE
bbabaabadcbdaabaacbaaccbdcadcabdcaccdacba	TRUE
dbabaabadcbdaabaacbaaccbdcadcabdcaccdacba	FALSE
bbabdddcdaaaccabdbabadaabadddacbdbdaabaab	TRUE
dbabdddcdaaaccabdbabadaabadddacbdbdaabaab	FALSE
bbadabccaabaabdcbcbddbcdbabdaabdcbabdcabd	TRUE
dbadabccaabaabdcbcbddbcdbabdaabdcbabdcabd	FALSE
bbadddadbdaaccbcccdbdcccddcaddbdbddbddda	TRUE
dbadddadbdaaccbcccdbdcccddcaddbdbddbddda	FALSE
bbcbaabaccacdadddacacdabcccabdbdcadbabccb	TRUE
dbcbaabaccacdadddacacdabcccabdbdcadbabccb	FALSE
bbccaaaadcacabcababdabccdabaddacdbacacaba	TRUE
dbccaaaadcacabcababdabccdabaddacdbacacaba	FALSE
bbcdabadbdbabdcbcdbacbcbaaaacacdcccdacddc	TRUE
dbcdabadbdbabdcbcdbacbcbaaaacacdcccdacddc	FALSE
bbdaacddaabddcaabadbdcbdaddbaadabccbacbca	TRUE
dbdaacddaabddcaabadbdcbdaddbaadabccbacbca	FALSE
bbdbabadccaaabaabdbabccadaaddcccdcdcdadac	TRUE
dbdbabadccaaabaabdbabccadaaddcccdcdcdadac	FALSE
bbdcaaaadaadbcbddddacbabdcccbdbcbcaccbcdc	TRUE
dbdcaaaadaadbcbddddacbabdcccbdbcbcaccbcdc	FALSE
bbdcdcbaaaadbdcbddcdbacabdddbadbcabcbdabd	TRUE
dbdcdcbaaaadbdcbddcdbacabdddbadbcabcbdabd	FALSE
bbdddaddbcaadcadddabcaaccadbdddbacdccdcbd	TRUE
dbdddaddbcaadcadddabcaaccadbdddbacdccdcbd	FALSE
cabbaddddbadadaadbdaccabadbaabccdaacdbca	TRUE
cacbaddddbadadaadbdaccabadbaabccdaacdbca	FALSE
cbbabcbadaaaddbabccdcadcabcdccdbcbadaccdc	TRUE
cbabcbadaaaddbabccdcadcabcdccdbcbadaccdc	FALSE
cbbdbccccdacdcbcacbdcbdbdddadbcbcdadabacd	TRUE
cbdbccccdacdcbcacbdcbdbdddadbcbcdadabacd	FALSE
cbbcbdcacababcbcbacddbdbacadbddcbcdbdbcab	TRUE
cabcbdcacababcbcbacddbdbacadbddcbcdbdbcab	FALSE
cbbabcabddddaaccccacabcbadcbaddaadddcabcc	TRUE
cbdbabcabddddaaccccacabcbadcbaddaadddcabcc	FALSE
cbdabbabcaabcddccbdadabcaaadabddddbadacc	TRUE
cbdaababcaabcddccbdadabcaaadabddddbadacc	FALSE
cbbcdccddbcadaabddbcbcaddabdcadcbcdbcbcac	TRUE
ccbcdccddbcadaabddbcbcaddabdcadcbcdbcbcac	FALSE
cbbadacaaddcaccbaccdabaabdbaaaaccdbccdaa	TRUE
cdbadacaaddcaccbaccdabaabdbaaaaccdbccdaa	FALSE
cbbdcbdccccdcbdcdbddcacaabcdaddadbabddcba	TRUE
cdbdcbdccccdcbdcdbddcacaabcdaddadbabddcba	FALSE
ccbbbdaadcabababacbaddcbadbddaaccbcdcbab	TRUE
ccbdbdaadcabababacbaddcbadbddaaccbcdcbab	FALSE
cdbbaaaddbaaadaaaacdaddcaacbcdaacaddaadba	TRUE
cdbaaaddbaaadaaaacdaddcaacbcdaacaddaadba	FALSE
cdcbbdcacccccaabcacdacdbdabdddcbcadccbcc	TRUE
cdccbdcacccccaabcacdacdbdabdddcbcadccbcc	FALSE
dabcbbdacdccddddcdbccadbcbddcadadbdacbddd	TRUE
dabcbadacdccddddcdbccadbcbddcadadbdacbddd	FALSE
dbbabdbcdcdaacbcacbcabacbdcbcaacdbcbadbab	TRUE
dbabdbcdcdaacbcacbcabacbdcbcaacdbcbadbab	FALSE
dbbdbccbdbcacddacbdccdadcbccbdcacdccddbac	TRUE
dbdbccbdbcacddacbdccdadcbccbdcacdccddbac	FALSE
dbbcbcbdadaaabacabadccbcbdbabaadbadcbdadc	TRUE
dabcbcbdadaaabacabadccbcbdbabaadbadcbdadc	FALSE
dbbdddcdaacbcbccaddacadadadbdddccbccdccdb	TRUE
dabdddcdaacbcbccaddacadadadbdddccbccdccdb	FALSE
dbbcdcdabcccdcbcbadbadbadabdccacbabdaddcb	TRUE
dbacdcdabcccdcbcbadbadbadabdccacbabdaddcb	FALSE
dbbadaadadaaabcdbaaccabaccadcdadbadccabdd	TRUE
dcbadaadadaaabcdbaaccabaccadcdadbadccabdd	FALSE
dbbdcccadaddcdacabaccdbdcbaabcbcbcabdacd	TRUE
dcbdcccadaddcdacabaccdbdcbaabcbcbcabdacd	FALSE
dbbcdabdddcabcdbcddcccbccdccaabcbcababdac	TRUE
ddbcdabdddcabcdbcddcccbccdccaabcbcababdac	FALSE
dcadbbaadccabdbabcacaaddcbcbdbcadbcdbcbad	TRUE
dcadbaadccabdbabcacaaddcbcbdbcadbcdbcbad	FALSE
dcbbabcdccdcadcccbacddabaaaadabdaadcbddda	TRUE
dcdbabcdccdcadcccbacddabaaaadabdaadcbddda	FALSE
ddbbdddcbdcdaaabdbadbadabcdbdbddbcccaabad	TRUE
ddabdddcbdcdaaabdbadbadabcdbdbddbcccaabad	FALSE
aaaadabbdadababccdbcbabdcadcdacbadcbaccbdddaad	TRUE
aaaadabdadababccdbcbabdcadcdacbadcbaccbdddaad	FALSE
aabbaacbcadcccbdacdbccbcbaadccbcdddcabddacacda	TRUE
aadbaacbcadcccbdacdbccbcbaadccbcdddcabddacacda	FALSE
abbacdcdcdcacdcbabcabcaddbaaaabdaacbaddadbdcdb	TRUE
abacdcdcdcacdcbabcabcaddbaaaabdaacbaddadbdcdb	FALSE
abbdcabdcccdadbdcdcaadcdbdbdcdbddbdabcaaaadddc	TRUE
abdcabdcccdadbdcdcaadcdbdbdcdbddbdabcaaaadddc	FALSE
abbcbdccdbddbccbdaadccdababdbaacacacabdddbccaa	TRUE
aabcbdccdbddbccbdaadccdababdbaacacacabdddbccaa	FALSE
abbccbddbddddacdaacdcdccbcccbcbadababccddddbad	TRUE
ababccbddbddddacdaacdcdccbcccbcbadababccddddbad	FALSE
abbbdccadacccbcbdbdbcaaadcaadbcbcdbacdbcbdbada	TRUE
abdbdccadacccbcbdbdbcaaadcaadbcbcdbacdbcbdbada	FALSE
abbcbcababdaacccbcccccdbcaadbacdbcbcabcccaadca	TRUE
acbcbcababdaacccbcccccdbcaadbacdbcbcabcccaadca	FALSE
abbabdaadbdadbaccabddacabdcbcadabddbddaaabdbad	TRUE
adbabdaadbdadbaccabddacabdcbcadabddbddaaabdbad	FALSE
abbdbabdcacdaccadadabdaabcaaabcdbcccbccaabcccc	TRUE
adbdbabdcacdaccadadabdaabcaaabcdbcccbccaabcccc	FALSE
acbbcdbcdbccdbddcdabdcabacadbabacdaccbcaabcdd	TRUE
acbabcdbcdbccdbddcdabdcabacadbabacdaccbcaabcdd	FALSE
adabbccbabdddbadbabcbcabdcabcdbaadcddacdcadccb	TRUE
adabccbabdddbadbabcbcabdcabcdbaadcddacdcadccb	FALSE
adbbcbccccbdaacccbdcaacddadaaaccbabaacbaaaacdb	TRUE
addbcbccccbdaacccbdcaacddadaaaccbabaacbaaaacdb	FALSE
bbaabdbdcbabacddabaaccdbcacccbcbdccccbaacccadb	TRUE
baabdbdcbabacddabaaccdbcacccbcbdccccbaacccadb	FALSE
bbabaddababcccaaccbdddccbcabdcbcaaabcabadaaddd	TRUE
babaddababcccaaccbdddccbcabdcbcaaabcabadaaddd	FALSE
bbacbcbdadcbdcdcabdbaccdbacdbaddaababcddadddb	TRUE
bacbcbdadcbdcdcabdbaccdbacdbaddaababcddadddb	FALSE
bbadbabdcddccdbdbddddbddaaaaddadadacadddbaaacb	TRUE
badbabdcddccdbdbddddbddaaaaddadadacadddbaaacb	FALSE
bbcabaabcadcdaabdddcdcdbcddcbccbcdbacdbdcdabac	TRUE
bcabaabcadcdaabdddcdcdbcddcbccbcdbacdbdcdabac	FALSE
bbcbabddbdcbadaadbddacccbddcacabcbacdcaaabaccc	TRUE
bcbabddbdcbadaadbddacccbddcacabcbacdcaaabaccc	FALSE
bbccaaababdbadcddbcbdbabcbadbaababdbcccbcbdac	TRUE
bccaaababdbadcddbcbdbabcbadbaababdbcccbcbdac	FALSE
bbccddbccccbcbacdaaccacdbcbcabdddbdabcacccbabd	TRUE
bccddbccccbcbacdaaccacdbcbcabdddbdabcacccbabd	FALSE
bbcdddabdcdaaaaaacbacbdaddddadabdcbcbaaacdcbcc	TRUE
bcdddabdcdaaaaaacbacbdaddddadabdcbcbaaacdcbcc	FALSE
bbdacddcadacbaabddbabdbcccdacadcdadbaacdcbddba	TRUE
bdacddcadacbaabddbabdbcccdacadcdadbaacdcbddba	FALSE
bbdbdadcdaadccacacabcddbaccacbadbddbddaaccddaa	TRUE
bdbdadcdaadccacacabcddbaccacbadbddbddaaccddaa	FALSE
bbdccdbcccddbdbdcccabadbdbaaabcacbddabccccbcd	TRUE
bdccdbcccddbdbdcccabadbdbaaabcacbddabccccbcd	FALSE
bbddccaaacaccdadcaabaadddaaccdaccbdcdddddadbac	TRUE
bddccaaacaccdadcaabaadddaaccdaccbdcdddddadbac	FALSE
bbaacbddacabaacdcaccbacddbadddddbadbacdccaddca	TRUE
abaacbddacabaacdcaccbacddbadddddbadbacdccaddca	FALSE
bbabcdcaccbcacbcbaddddcddbaabadcbddbdbdcdbacb	TRUE
ababcdcaccbcacbcbaddddcddbaabadcbddbdbdcdbacb	FALSE
bbaccbdcdbacaacabadcbcccaacacaabdcbaabcadbadd	TRUE
abaccbdcdbacaacabadcbcccaacacaabdcbaabcadbadd	FALSE
bbadcbcaadccbddaaacdcabaccdcdadbcdbccbcddacdcd	TRUE
abadcbcaadccbddaaacdcabaccdcdadbcdbccbcddacdcd	FALSE
bbcacdabccbcdcdabcdcdbacdacaccbccccdacdabadcc	TRUE
abcacdabccbcdcdabcdcdbacdacaccbccccdacdabadcc	FALSE
bbcbccddaaacabcbcabcbabdcdcbabadbdbddbabdbcbdb	TRUE
abcbccddaaacabcbcabcbabdcdcbabadbdbddbabdbcbdb	FALSE
bbccbdcbabdcbaaddccacdddaadaccbcbccbacaccccddd	TRUE
abccbdcbabdcbaaddccacdddaadaccbcbccbacaccccddd	FALSE
bbcdbdcdacaddbccacbddccddcaaaacbdbcababacdbcbd	TRUE
abcdbdcdacaddbccacbddccddcaaaacbdbcababacdbcbd	FALSE
bbdabccadccbcadcdbadbabadbcdcabddbdcaddbdcbada	TRUE
abdabccadccbcadcdbadbabadbcdcabddbdcaddbdcbada	FALSE
bbdbadcbcbacaccdccacbabaacaadaddaabaaaadbcddba	TRUE
abdbadcbcbacaccdccacbabaacaadaddaabaaaadbcddba	FALSE
bbdcbacaaaadbcaaaccbcdcabcbcbadacdcddbdabcabd	TRUE
abdcbacaaaadbcaaaccbcdcabcbcbadacdcddbdabcabd	FALSE
bbddbccbccbacbaaabccbadcdcadbccbddabccaddddbdd	TRUE
abddbccbccbacbaaabccbadcdcadbccbddabccaddddbdd	FALSE
bbacbabcbaadadcabdcabccdcdadcadcadccdbdccdcba	TRUE
babacbabcbaadadcabdcabccdcdadcadcadccdbdccdcba	FALSE
bbaadabacacbcadabddbdcdacdaccabaccbcaddbdcdadb	TRUE
bcbaadabacacbcadabddbdcdacdaccabaccbcaddbdcdadb	FALSE
bbdbcbddabccbcccabcbacbcbadbddaaccbcdcbaacbdcc	TRUE
bcbdbcbddabccbcccabcbacbcbadbddaaccbcdcbaacbdcc	FALSE
bbcdcbddddacdaacaabdbaadaadcbaaabcbabacddcccdb	TRUE
bdbcdcbddddacdaacaabdbaadaadcbaaabcbabacddcccdb	FALSE
babcbbcadbcbdadbabdaabcacabaadcbdbdbcaadcdcbd	TRUE
babcbcadbcbdadbabdaabcacabaadcbdbdbcaadcdcbd	FALSE
bbacbadcaabddcaadbcdbdaaacdbcaadaadabdaaabccad	TRUE
bacbadcaabddcaadbcdbdaaacdbcaadaadabdaaabccad	FALSE
bbddcbcbdabacaacdabdadadddadccbddcddbdcddaaccd	TRUE
bddcbcbdabacaacdabdadadddadccbddcddbdcddaaccd	FALSE
bbccccacccdcbcbddaacbccbacadddddcbaccbdddcccd	TRUE
baccccacccdcbcbddaacbccbacadddddcbaccbdddcccd	FALSE
bbbddabddcdbdbacdbabaabccadadcdcabcdcacaddcdbc	TRUE
bcbddabddcdbdbacdbabaabccadadcdcabcdcacaddcdbc	FALSE
bbbcdaabccacbababcbcdddcbccbdacbacdaaadcabacca	TRUE
bdbcdaabccacbababcbcdddcbccbdacbacdaaadcabacca	FALSE
bcadbabbaaadcdbdaacabaaaaabaccbdccbcccbccabdba	TRUE
bcadbadbaaadcdbdaacabaaaaabaccbdccbcccbccabdba	FALSE
bcdbbaacccaabadcdcadadaabdadbdbdaccbadbaccdaa	TRUE
bcdbaacccaabadcdcadadaabdadbdbdaccbadbaccdaa	FALSE
bdbbcdbdadbdaccaacbcdcdcadaddcccbcccbdababcaba	TRUE
bddbcdbdadbdaccaacbcdcdcadaddcccbcccbdababcaba	FALSE
bbaabcdacabdbcacdcbccaacbcbcaadbaddabdaacccbd	TRUE
cbaabcdacabdbcacdcbccaacbcbcaadbaddabdaacccbd	FALSE
bbabcadddcdddbcdccaacacbabdacdababaacaabcdbada	TRUE
cbabcadddcdddbcdccaacacbabdacdababaacaabcdbada	FALSE
bbacbdcbddaaddddcaccddadccaadaabacdddbdacbaaac	TRUE
cbacbdcbddaaddddcaccddadccaadaabacdddbdacbaaac	FALSE
bbadbcbdccaabdcdbddbcccbdaadaaddabaabacbabadcc	TRUE
cbadbcbdccaabdcdbddbcccbdaadaaddabaabacbabadcc	FALSE
bbcabcbdbccaddcdcadaaaadbadbdadcdabcbadbaaacad	TRUE
cbcabcbdbccaddcdcadaaaadbadbdadcdabcbadbaaacad	FALSE
bbcbcaaaabacbabadbcddbdcabcbcabcababcdbcadccbc	TRUE
cbcbcaaaabacbabadbcddbdcabcbcabcababcdbcadccbc	FALSE
bbccbaaabcadddddcdbcaaccacbddbdcdcaababccadccb	TRUE
cbccbaaabcadddddcdbcaaccacbddbdcdcaababccadccb	FALSE
bbcdadbcbdbaacbcdcdadbaddcbdacdadcbabdbadaaab	TRUE
cbcdadbcbdbaacbcdcdadbaddcbdacdadcbabdbadaaab	FALSE
bbdaacdacbaacbddcccdbcdbdbcdcdccbddacdabdadcc	TRUE
cbdaacdacbaacbddcccdbcdbdbcdcdccbddacdabdadcc	FALSE
bbdbaaddadadadcdbabddccadddaccbdbabcdcccdcabda	TRUE
cbdbaaddadadadcdbabddccadddaccbdbabcdcccdcabda	FALSE
bbdbddbadaddaacabacaabdcaabcbacdcdbccdabcabacd	TRUE
cbdbddbadaddaacabacaabdcaabcbacdcdbccdabcabacd	FALSE
bbdcdbdaabdaababacdbdddcabddbadcbccdcdbdbdcdbc	TRUE
cbdcdbdaabdaababacdbdddcabddbadcbccdcdbdbdcdbc	FALSE
bbdddacbdcccdadaabdbccccbadbacddddcbdaabdbaacd	TRUE
cbdddacbdcccdadaabdbccccbadbacddddcbdaabdbaacd	FALSE
bbaadaddcbacdbcbcccdadabdadadbaabcadcaacaabdb	TRUE
dbaadaddcbacdbcbcccdadabdadadbaabcadcaacaabdb	FALSE
bbabdcbcbaaabccabadbadbdaadcabdcabdcbaaadbabd	TRUE
dbabdcbcbaaabccabadbadbdaadcabdcabdcbaaadbabd	FALSE
bbaccdcaacaabccbabacbaadcacaabdcabcbdcbcbdbabc	TRUE
dbaccdcaacaabccbabacbaadcacaabdcabcbdcbcbdbabc	FALSE
bbadcaddaddadbddacbdaaadababdbdbacadccbdabccdb	TRUE
dbadcaddaddadbddacbdaaadababdbdbacadccbdabccdb	FALSE
bbcaccaabcbcacddcbdbadcccbdcdcddaaaaabcdacacd	TRUE
dbcaccaabcbcacddcbdbadcccbdcdcddaaaaabcdacacd	FALSE
bbcbcdccababadcbdaddadbacccbdcbdacccbabcacdcb	TRUE
dbcbcdccababadcbdaddadbacccbdcbdacccbabcacdcb	FALSE
bbccdabaccacdcdaababaacddbaaddccbcbcdadabaccc	TRUE
dbccdabaccacdcdaababaacddbaaddccbcbcdadabaccc	FALSE
bbcdccddbadbaccabddcdddacbcbdcdacbaaaacaababdb	TRUE
dbcdccddbadbaccabddcdddacbcbdcdacbaaaacaababdb	FALSE
bbdadbcabdaaacbcabaadbcadaaaddcbaaadbcadcbddcc	TRUE
dbdadbcabdaaacbcabaadbcadaaaddcbaaadbcadcbddcc	FALSE
bbdbdbcaccdacacabddbcdabdcbcbaacadbaacdacdcadd	TRUE
dbdbdbcaccdacacabddbcdabdcbcbaacadbaacdacdcadd	FALSE
bbdcdcabdacdbddaadcbdcdbcaadabdaccdaabcdacaddc	TRUE
dbdcdcabdacdbddaadcbdcdbcaadabdaccdaabcdacaddc	FALSE
bbdddbdabdddabdccaabaaacabaaccbdabcdabcacdaaca	TRUE
dbdddbdabdddabdccaabaaacabaaccbdabcdabcacdaaca	FALSE
cabbcdccdbccaacdaddabcacdbddcddbcdbdabcaabdbd	TRUE
cabcdccdbccaacdaddabcacdbddcddbcdbdabcaabdbd	FALSE
cbbaadadbcdbcbcdadacabcdbddaabdcbcacadddaddcdc	TRUE
cbaadadbcdbcbcdadacabcdbddaabdcbcacadddaddcdc	FALSE
cbbdaacbcdaddddaabcbabddcabaabdbcdaacbaccabadc	TRUE
cbdaacbcdaddddaabcbabddcabaabdbcdaacbaccabadc	FALSE
cbbadbabadaabaadcaccdbdcdbaaddbabdbcacbccbccc	TRUE
cabadbabadaabaadcaccdbdcdbaaddbabdbcacbccbccc	FALSE
cbbddcacbddcbdccbdcdccdcbabccaddbcdabccdddbca	TRUE
cabddcacbddcbdccbdcdccdcbabccaddbcdabccdddbca	FALSE
cbbabcbdcddbcabdcabddcbabcdacdcabadbcbcddabccd	TRUE
cbcabcbdcddbcabdcabddcbabcdacdcabadbcbcddabccd	FALSE
cbbadbabddbdddcccbdcbcccbabdaabcaaacbddaacdcb	TRUE
ccbadbabddbdddcccbdcbcccbabdaabcaaacbddaacdcb	FALSE
cbbaabacadcbabadcbcadccdcddcabccaabcdcacabddaa	TRUE
cdbaabacadcbabadcbcadccdcddcabccaabcdcacabddaa	FALSE
cbbdaacbcccbaacbcbaabdccbdbcdaadcabcabdcaabdda	TRUE
cdbdaacbcccbaacbcbaabdccbdbcdaadcabcabdcaabdda	FALSE
ccbbcadabdbabcadbcabdcacdbaddbddacccccbadddddc	TRUE
ccbcadabdbabcadbcabdcacdbaddbddacccccbadddddc	FALSE
ccccbbcabcbdacbdcadcbdacdaccabababdaaabddaaaa	TRUE
ccccbcabcbdacbdcadcbdacdaccabababdaaabddaaaa	FALSE
cdbbdbdccbcbdbdbccccccabacdaccbdbdabcccbcdabd	TRUE
cdcbdbdccbcbdbdbccccccabacdaccbdbdabcccbcdabd	FALSE
dabbadbcbcaaabaaabacbcdadddcbaacccababacbddbdc	TRUE
daabadbcbcaaabaaabacbcdadddcbaacccababacbddbdc	FALSE
dadcbbababaaddddbcbcccabdddbcdabdbddcabacdbdcd	TRUE
dadcbcababaaddddbcbcccabdddbcdabdbddcabacdbdcd	FALSE
dbbdacadcbacaadaaabcbccaabadbcbabaaaccbddbccac	TRUE
dbdacadcbacaadaaabcbccaabadbcbabaaaccbddbccac	FALSE
dbbcadacccbadccbaccccbcbcbadbdbabcbddacaccaabd	TRUE
dabcadacccbadccbaccccbcbcbadbdbabcbddacaccaabd	FALSE
dbbdddccaccddcdadbcaadbdbdddbdaccbcdddbcccabcd	TRUE
dabdddccaccddcdadbcaadbdbdddbdaccbcdddbcccabcd	FALSE
dbbcccacbccacabdacacdacacaacddcdcbadbccbdadcab	TRUE
dbacccacbccacabdacacdacacaacddcdcbadbccbdadcab	FALSE
dbbadaabaacabddaadaacacaacdbdccccaddbacdaabdca	TRUE
dcbadaabaacabddaadaacacaacdbdccccaddbacdaabdca	FALSE
dbbdcbaddacbcccaaadcadacddabcacadbdcaccbcbcbcb	TRUE
dcbdcbaddacbcccaaadcadacddabcacadbdcaccbcbcbcb	FALSE
dbbccbcccaccdbadcbcddbdcbcbdabdaabdbdacbdbadcb	TRUE
ddbccbcccaccdbadcbcddbdcbcbdabdaabdbdacbdbadcb	FALSE
dcabbdbdbacaddbaacaddadcddbaaaadbcabddcddadbdc	TRUE
dcacbdbdbacaddbaacaddadcddbaaaadbcabddcddadbdc	FALSE
dccabbcaddcdcacdabaadcacdbadaacbabddacaacadcbd	TRUE
dccaabcaddcdcacdabaadcacdbadaacbabddacaacadcbd	FALSE
ddbbcacacdbccabdcdbddadaaadaddbcdbcabcbaacbcdd	TRUE
ddbcbcacacdbccabdcdbddadaaadaddbcdbcabcbaacbcdd	FALSE
